2 sim	count=3
2d	count=3
3d full hd	count=3
3d led	count=3
amoled	count=3
viền	count=3
bios	count=3
blu-ray	count=3
bluetooth 3.0	count=3
bàn phím thường	count=3
bút điện tử	count=3
bảo mật	count=3
bảo vệ dữ liệu	count=3
bắt hình	count=3
bắt sóng wi-fi	count=3
bằng kim loại	count=3
bằng nhôm	count=3
bề mặt gương	count=3
bề mặt trên	count=3
bộ giải mã	count=3
bộ nhớ lưu trữ	count=3
bộ nhớ rom	count=3
bộ phần mềm	count=3
bộ pin	count=3
bộ thu wi-fi	count=3
bộ vỏ	count=3
bức ảnh chụp	count=3
wi-fi	count=3
chat chit	count=3
chip xử lý hình ảnh	count=3
chip xử lý ảnh	count=3
chiều ngang	count=3
chuẩn 16:9	count=3
chuẩn full hd	count=3
chơi game 3d	count=3
chơi video	count=3
chạy đa nhiệm	count=3
chất lượng hình	count=3
chất lượng quay video	count=3
chất lượng chụp hình	count=3
chất lượng vỏ máy	count=3
chất lượng stereo	count=3
chế độ 3d	count=3
chế độ auto	count=3
chế độ chụp liên tiếp	count=3
chế độ hiển thị	count=3
chế độ pasm	count=3
chế độ quay phim	count=3
chế độ tự động canh nét	count=3
chịu nhiệt	count=3
chịu nước	count=3
chống nhòe	count=3
chống chầy	count=3
chụp phong cảnh	count=3
chụp thiếu sáng	count=3
chụp toàn cảnh	count=3
chức năng handheld twilight	count=3
copy/paste	count=3
cuộc gọi video	count=3
công cụ bảo mật	count=3
công nghệ led nền	count=3
cạnh tranh	count=3
cảm biến hình ảnh	count=3
cảm biến mos	count=3
cổng bluetooth	count=3
cổng esata/usb combo	count=3
cổng kết nối hdmi	count=3
cổng kết nối usb	count=3
cổng mini-hdmi	count=3
cổng quang	count=3
cổng xuất hình vga	count=3
danh tiếng	count=3
display	count=3
displayport	count=3
divx	count=3
dts	count=3
dung lượng pin	count=3
dvb-t	count=3
dáng hình	count=3
dây đeo	count=3
dãy đèn led	count=3
dịch vụ	count=3
esata/usb combo	count=3
file dữ liệu	count=3
file video divx	count=3
file ảnh	count=3
gam màu	count=3
ghi hình	count=3
ghi video	count=3
gian ứng dụng	count=3
giao diện cảm ứng	count=3
giao diện metro	count=3
giá	count=3
giá bán	count=3
giá chính hãng	count=3
giá sản phẩm	count=3
giả lập	count=3
giả lập âm thanh vòm	count=3
giải mã	count=3
giải trí gia dụng	count=3
giắc cắm sạc	count=3
giắc headphone	count=3
giắc kết nối	count=3
giắc micro/headphone	count=3
giọng nói	count=3
gmail	count=3
góc nghiêng	count=3
góc trái	count=3
góc phải	count=3
gờ cong	count=3
hiển thị màu sắc	count=3
hiện tượng rung	count=3
hiệu quả trình diễn	count=3
hiệu ứng 3d	count=3
hiệu ứng 3d giả lập	count=3
hspda	count=3
hàng chính hãng	count=3
hướng tới người dùng trẻ	count=3
hệ thống chuyển đổi	count=3
hệ thống tản nhiệt	count=3
hệ thống đèn chiếu	count=3
hệ thống đèn led	count=3
hệ điều hành chính	count=3
họa tiết hoa văn	count=3
hỗ trợ flash	count=3
hợp kim magie	count=3
hợp kim magiê	count=3
in chìm	count=3
instant on	count=3
khay sim	count=3
khe cắm nguồn	count=3
khe cắm sạc	count=3
khe cắm thẻ mở rộng expresscard/34	count=3
khe cắm thẻ sim	count=3
khe cắm sim	count=3
khe đọc thẻ	count=3
khe đọc thẻ nhớ	count=3
khung hình ảnh	count=3
khung viền	count=3
khung viền màn hình	count=3
khung nhôm	count=3
khả năng kết nối	count=3
khả năng lấy nét tự động	count=3
khả năng tối ưu phần cứng	count=3
khả năng bắt sóng	count=3
khả năng tương thích	count=3
khả năng quay video	count=3
khả năng quay video trong điều kiện thiếu sáng	count=3
khả năng quay video trong điều kiện thiếu sáng yếu	count=3
khả năng quay video thiếu sáng	count=3
khả năng quay video sáng yếu	count=3
khả năng quay video đủ sáng	count=3
khả năng quay video ban ngày	count=3
khả năng quay video trong điều kiện sáng yếu	count=3
khả năng quay video trong điều kiện đủ sáng	count=3
khả năng quay video lúc ban ngày	count=3
khả năng chụp ảnh trong điều kiện thiếu sáng	count=3
khả năng chụp ảnh trong điều kiện thiếu sáng yếu	count=3
khả năng chụp ảnh thiếu sáng	count=3
khả năng chụp ảnh sáng yếu	count=3
khả năng chụp ảnh đủ sáng	count=3
khả năng chụp ảnh ban ngày	count=3
khả năng chụp ảnh trong điều kiện sáng yếu	count=3
khả năng chụp ảnh trong điều kiện đủ sáng	count=3
khả năng chụp ảnh lúc ban ngày	count=3
khả năng tự động lấy nét	count=3
khả năng xử lý đa nhiệm	count=3
khả năng xử lý đồ họa	count=3
kiểu ảnh	count=3
kết nối cơ bản	count=3
kết nối dlna	count=3
kết nối ethernet	count=3
kết nối gprs	count=3
kết nối với máy tính	count=3
la bàn	count=3
linh kiện điện tử	count=3
live-view	count=3
loa chính	count=3
loa điện thoại	count=3
loa subwoofer	count=3
lưu trữ	count=3
lưu ảnh	count=3
lớp sơn	count=3
lớp vỏ nhôm	count=3
lớp vỏ nhựa	count=3
nfc	count=3
giao tiếp nfc	count=3
giao tiếp tầm ngắn	count=3
giao tiếp tầm gần	count=3
giao tiếp tầm ngắn nfc	count=3
giao tiếp tầm gần nfc	count=3
ảnh chụp tối	count=3
ảnh chụp đêm	count=3
ảnh chụp ban tối	count=3
ảnh chụp ban đêm	count=3
ống kính camera thiếu sáng	count=3
ống kính camera chụp thiếu sáng	count=3
ảnh chụp ngày	count=3
lời thoại	count=3
menu điều khiển	count=3
microsim	count=3
mini game	count=3
màn hình 3d	count=3
màn hình cảm ứng đa điểm	count=3
màn hình cảm ứng	count=3
màn hình chạm	count=3
màn hình trước	count=3
màn hình sau	count=3
màn ảnh	count=3
màu sơn	count=3
màu sắc	count=3
máy ảnh chống nước	count=3
máy ảnh siêu zoom	count=3
mạ bạc	count=3
mạ chrome	count=3
mạch điện tử	count=3
mạch tích hợp	count=3
mặt kính	count=3
mặt lưng	count=3
mặt ngoài	count=3
mặt trong	count=3
mức nhạy sáng	count=3
mức zoom	count=3
ngõ cắm headphone	count=3
ngõ vào	count=3
ngôn ngữ	count=3
ngõ xuất hình hdmi	count=3
nhôm khối	count=3
nhạc nền	count=3
nhận biết ánh sáng	count=3
nhận diện khuôn mặt	count=3
nén nhạc	count=3
nút fn	count=3
nút func/set	count=3
nút gọi điện	count=3
nút menu	count=3
nút truy cập nhanh	count=3
nút tăng giảm âm lượng	count=3
nắp bảo vệ	count=3
nắp che	count=3
nắp máy	count=3
nắp trượt	count=3
nội dung đa phương tiện	count=3
phát nhạc	count=3
phím bấm vật lý	count=3
phím bật/tắt nguồn	count=3
phím cảm ứng đa phương tiện	count=3
phím cứng	count=3
phím phụ	count=3
phím số	count=3
phản hồi	count=3
phản ứng	count=3
phần mềm	count=3
phần mềm diệt virus	count=3
phần mềm thương mại	count=3
phần mềm tích hợp	count=3
phần mềm ứng dụng	count=3
phần trên	count=3
phối màu	count=3
playlist	count=3
podcast	count=3
program	count=3
quang sai màu	count=3
quay film	count=3
quay phim full hd	count=3
quản lý	count=3
qvga	count=3
qwerty	count=3
siêu di động	count=3
siêu trầm	count=3
soạn thảo e-mail	count=3
sách hướng dẫn sử dụng	count=3
sơn phủ	count=3
sạc lại	count=3
sức mạnh xử lý	count=3
sự lựa chọn	count=3
tai nghe không dây	count=3
thanh space	count=3
thay pin	count=3
thư giãn	count=3
thư mục	count=3
thư viện nội dung	count=3
thưởng thức phim	count=3
thấu kính	count=3
thẻ microsd	count=3
thẻ sd	count=3
thẻ sdxc	count=3
thời gian hoạt động	count=3
thời gian xử lý	count=3
thời gian đàm thoại	count=3
thời gian xem video	count=3
thời gian đáp ứng	count=3
thời lượng chạy	count=3
thời lượng chạy máy	count=3
thời lượng dùng pin	count=3
thực hiện cuộc gọi	count=3
thực thi đa tác vụ	count=3
tiêu chuẩn	count=3
tiêu tốn năng lượng	count=3
tiết kiệm điện	count=3
tiết kiệm chi phí	count=3
tiết kiệm năng lượng	count=3
tiết kiệm pin	count=3
tiện dụng	count=3
toàn thân	count=3
trackpoint	count=3
truy cập dữ liệu	count=3
truy cập internet	count=3
trình diễn 3d	count=3
trình diễn phim ảnh	count=3
trình điều khiển	count=3
trải nghiệm	count=3
trực tuyến	count=3
tua qua hình	count=3
tác dụng	count=3
tích hợp sẵn	count=3
tính chính xác	count=3
tính di động	count=3
tính năng chụp ảnh	count=3
tính năng cảm ứng nổi	count=3
tính năng cảm ứng siêu nhạy	count=3
tính năng kết nối	count=3
tính năng đàm thoại	count=3
tính năng cài sẵn	count=3
tạp âm	count=3
tải ứng dụng	count=3
tập tin divx hd	count=3
tốc độ bộ vi xử lý	count=3
tốc độ tải ứng dụng	count=3
tốc độ chạy đa nhiệm	count=3
tốc độ khởi động	count=3
tốc độ chạy	count=3
tốc độ chụp liên tiếp	count=3
tốc độ trung bình	count=3
tốc độ tải hình	count=3
tự động thiết lập	count=3
tự động điều chỉnh độ sáng	count=3
usb 2.0	count=3
usb 3.0	count=3
vi xử lí	count=3
vi xử lý	count=3
video hd	count=3
viên bi lăn	count=3
viền dưới	count=3
viền tím	count=3
vòng xoay	count=3
vòng điều khiển	count=3
webcam tích hợp	count=3
xem truyền hình	count=3
xem ảnh số	count=3
xoay màn hình	count=3
xoay tròn	count=3
xử lý nhiễu	count=3
xử lý đa nhiệm	count=3
zoom xa	count=3
điều chỉnh bù sáng	count=3
điều khiển giọng nói	count=3
điện năng tiêu thụ	count=3
năng lượng tiêu thụ	count=3
tiêu thụ năng lượng	count=3
đáp tuyến tần số	count=3
đáy máy	count=3
đèn tín hiệu	count=3
đèn viền	count=3
đường kết nối	count=3
đường rìa	count=3
đầu đọc blu-ray	count=3
đỉnh máy	count=3
định dạng video	count=3
định vị vệ tinh	count=3
đọc số điện thoại	count=3
đồng bộ	count=3
đồng bộ danh bạ	count=3
đồng bộ dữ liệu	count=3
độ chính xác	count=3
độ phân giải video	count=3
độ sâu màu	count=3
độ ồn	count=3
đủ sáng	count=3
ống góc	count=3
ống kit	count=3
ống kính góc rộng	count=3
ổ dvd	count=3
ổ ghi	count=3
ổ lưu trữ	count=3
ứng dụng cơ bản	count=3
ứng dụng media	count=3
ứng dụng thứ ba	count=3
3g/hsdpa	count=4
bao da	count=4
biên tập ảnh	count=4
bluetooth modem	count=4
bên dưới	count=4
bên ngoài	count=4
bật/tắt	count=4
bộ cảm biến	count=4
bộ xử lý đồ họa	count=4
bộ điều khiển	count=4
cache	count=4
card màn hình	count=4
chi phí	count=4
chiều dày	count=4
chuyển định dạng	count=4
chuyển đổi định dạng video	count=4
chíp xử lý	count=4
chất lượng hiển thị	count=4
việc tinh chỉnh	count=4
tùy biến phần mềm	count=4
chất lượng đàm thoại	count=4
chất lượng camera	count=4
chất lượng ảnh chụp	count=4
chất lượng phím bấm	count=4
chất lượng thoại	count=4
chất lượng mic	count=4
chất lượng màn hình	count=4
chất lượng thân máy	count=4
tuỳ biến phần mềm	count=4
chức năng quay phim HDR	count=4
chế độ chỉnh tay	count=4
chế độ hẹn giờ	count=4
chế độ toàn màn hình	count=4
chỉnh sửa	count=4
chỉnh âm lượng	count=4
chống chói	count=4
chống sốc	count=4
chống va đập	count=4
chống xước	count=4
chụp chân dung	count=4
chụp đêm	count=4
con trỏ	count=4
cáp truyền dữ liệu	count=4
công nghệ amoled	count=4
công nghệ chống sốc	count=4
công nghệ lcd	count=4
công suất phát	count=4
cạnh dọc	count=4
cạnh ngoài	count=4
cạnh đáy	count=4
cảm quang phụ	count=4
cổng giao tiếp micro usb	count=4
cổng sạc	count=4
cổng usb 3.0	count=4
cổng usb dac	count=4
cổng xuất hdmi	count=4
dây tai nghe	count=4
dải cao su	count=4
dễ sử dụng	count=4
giao diện menu	count=4
giắc audio	count=4
giắc cắm headphone/microphone	count=4
giắc âm thanh	count=4
gpu	count=4
góc nhìn ngang	count=4
hiển thị thông số menu	count=4
hiệu năng hoạt động	count=4
hiệu suất sử dụng	count=4
hspa	count=4
hàng phím chức năng	count=4
hình ảnh 2d	count=4
hình ảnh 3d	count=4
hình ảnh hiển thị	count=4
hình ảnh đồ họa	count=4
hệ số damping	count=4
hệ thống loa đôi	count=4
hệ thống nút bấm	count=4
hệ thống phím điều khiển	count=4
hợp kim nhôm	count=4
internet	count=4
khoảng lấy nét	count=4
khung bao	count=4
khung ngắm quang	count=4
khả năng khử nhiễu	count=4
khối lượng	count=4
kiểm soát nhiễu	count=4
kính ngắm	count=4
kính ngắm quang	count=4
kính ngắm điện tử	count=4
kết hợp	count=4
kỹ thuật	count=4
lớp vỏ ngoài	count=4
lớp kính cường lực	count=4
kính cường lực	count=4
lớp vỏ bọc	count=4
microsd	count=4
mic thoại	count=4
multimedia	count=4
màn hình amoled	count=4
màn hình phía trước	count=4
máy ảnh chính	count=4
máy ảnh phụ	count=4
mã hóa	count=4
mạ vàng	count=4
mật độ điểm ảnh	count=4
ngõ cắm	count=4
ngắt cuộc gọi	count=4
nhận cuộc gọi	count=4
nút bấm số	count=4
nút bật/tắt nguồn	count=4
nút quay video	count=4
phía trong	count=4
phím bấm chuột	count=4
phím camera	count=4
phím media	count=4
phím multimedia	count=4
phím mũi tên	count=4
phím truy cập nhanh	count=4
phím trỏ chuột	count=4
phím điều chỉnh âm lượng	count=4
phần mềm định vị	count=4
quay video hd	count=4
quản lý tin nhắn	count=4
riềm bao	count=4
sợi carbon	count=4
tay nắm	count=4
thanh công cụ	count=4
thanh ngang	count=4
thu âm	count=4
thư viện ảnh	count=4
thương hiệu	count=4
thưởng thức phim ảnh	count=4
thấu kính phi cầu	count=4
thẻ nhớ ngoài	count=4
thời gian trễ	count=4
tin nhắn mms	count=4
truy nhập	count=4
tráng bóng	count=4
trình diễn hình ảnh	count=4
trò chơi	count=4
trở kháng	count=4
tái hiện màu sắc	count=4
tín hiệu	count=4
tính cơ động	count=4
tính năng đa phương tiện	count=4
tông màu	count=4
tăng chỉnh âm lượng	count=4
tấm kính	count=4
tắt máy	count=4
tỏa nhiệt	count=4
tốc độ kết nối	count=4
tốc độ màn chập	count=4
tốc độ truyền dữ liệu	count=4
tỷ lệ khung hình	count=4
vi xử lý lõi kép	count=4
vi xử lý lõi tứ	count=4
vi xử lý lõi 8	count=4
vi xử lý lõi 6	count=4
vi xử lý tốc độ	count=4
viền trên	count=4
vuốt tròn	count=4
vành ánh kim	count=4
vành chụp tai	count=4
vân sần	count=4
vùng đặt tay	count=4
xem lịch	count=4
xem thời tiết	count=4
xách tay	count=4
xử lí âm thanh	count=4
xử lý ảnh	count=4
đa điểm chạm	count=4
đa định dạng	count=4
điểm ảnh	count=4
điểm số	count=4
đánh văn bản	count=4
được đánh giá	count=4
đầu phát hd	count=4
đẳng cấp	count=4
đặc tính	count=4
đế	count=4
đọc tin nhắn sms	count=4
đồng hồ bấm giờ	count=4
độ bù trừ sáng	count=4
độ dài	count=4
độ phản quang	count=4
độ sáng màn hình	count=4
ống kính camera	count=4
ổ quang đọc/ghi dvd	count=4
ổn định hình ảnh	count=4
2 sim 2 sóng	count=5
bo mạch	count=5
cạnh bên	count=5
bù sáng	count=5
bản nâng cấp	count=5
bộ phận điều hướng	count=5
bộ xử lý ảnh	count=5
chuẩn qvga	count=5
chính giữa	count=5
chất liệu	count=5
chất liệu vỏ	count=5
chất liệu vỏ trước	count=5
vỏ sau	count=5
vỏ trước	count=5
lớp vỏ sau	count=5
lớp vỏ trước	count=5
chất liệu vỏ sau	count=5
chất liệu vỏ máy	count=5
chất âm	count=5
chế độ tiết kiệm điện	count=5
chế độ tự động	count=5
chống bụi	count=5
chống lóa	count=5
chống ồn	count=5
chụp lia panorama	count=5
chụp xa	count=5
chụp ảnh tĩnh	count=5
các nút bấm	count=5
các phím	count=5
cách bố trí	count=5
cạnh dưới	count=5
cạnh trên	count=5
cạnh viền	count=5
cấu hình phần cứng	count=5
cấu tạo	count=5
cổng displayport	count=5
d-pad	count=5
dây dẫn	count=5
express card	count=5
expresscard	count=5
game 3d	count=5
ghi chú	count=5
ghi lại	count=5
giao diện người dùng	count=5
giãn cách	count=5
góc cạnh	count=5
gờ bao	count=5
hai bên máy	count=5
hai màn hình	count=5
hai phím chuột	count=5
phím home	count=5
nút home	count=5
hẹn giờ	count=5
hệ thống âm thanh	count=5
hệ thống ổn định hình ảnh	count=5
khe cắm expresscard/34	count=5
khe cắm mở rộng	count=5
khe cắm thẻ nhớ sd/mmc	count=5
khe cắm thẻ sim sd/mmc	count=5
khóa màn hình	count=5
không gian làm việc	count=5
khả năng phối màu	count=5
kết nối mạng ethernet	count=5
la bàn kỹ thuật số	count=5
linh kiện	count=5
loa con	count=5
loa surround	count=5
loa trước	count=5
lưng máy	count=5
màn cảm ứng	count=5
màn hình hiển thị	count=5
màn hình ngoài	count=5
màn hình	count=5
màu đen bóng	count=5
mạch điện	count=5
mạng 2g	count=5
mạng 3g	count=5
mạng 4g	count=5
nhôm nguyên khối	count=5
nhận diện vân tay	count=5
nhận dạng	count=5
nhận dạng khuôn mặt	count=5
nhập dữ liệu	count=5
nút chọn	count=5
nắp pin	count=5
nắp sau	count=5
nền tảng	count=5
phím gọi điện	count=5
phím tăng giảm âm lượng	count=5
phím tắt multimedia	count=5
phím tìm kiếm	count=5
phần mềm nghe nhạc	count=5
thiết bị ngoại vi	count=5
tháo lắp	count=5
thời gian dùng	count=5
thời lượng sử dụng pin	count=5
thời lượng sử dụng	count=5
chống tiếng ồn	count=5
trong suốt	count=5
truyền dữ liệu	count=5
truyền tải	count=5
tương phản	count=5
tương thích	count=5
tấm nền màn hình	count=5
tầm giá	count=5
tốc độ xuất	count=5
tốc độ xuất hình	count=5
vi xử lý lõi đơn	count=5
vòng tròn	count=5
văn bản	count=5
wireless	count=5
xác định vị trí	count=5
xử lý đa tác vụ	count=5
xử lý đồ họa	count=5
âm nhạc	count=5
âm trung	count=5
chụp ảnh điều kiện thiếu sáng	count=5
chụp ảnh điều kiện đủ sáng	count=5
đường nét thiết kế	count=5
đầu đọc	count=5
định vị vệ tinh gps	count=5
độ chính xác màu	count=5
độ phân giải	count=5
độ phủ	count=5
độ rung	count=5
độ động	count=5
ổ đĩa cứng	count=5
ứng dụng đồ họa	count=5
adapter	count=6
củ adapter	count=6
cục sạc 3 chấu	count=6
cục sạc 3 chân	count=6
cục sạc ba chấu	count=6
cục sạc ba chân	count=6
cục sạc tiêu chuẩn	count=6
củ sạc 3 chấu	count=6
củ sạc 3 chân	count=6
củ sạc ba chấu	count=6
củ sạc ba chân	count=6
củ sạc tiêu chuẩn	count=6
cục adapter	count=6
chế độ chụp autoforcus	count=6
bàn phím	count=6
bút cảm ứng	count=6
bề mặt ngoài	count=6
camera trước	count=6
camera sau	count=6
camera chính	count=6
camera phụ	count=6
camera ban ngày	count=6
camera ban đêm	count=6
camera lấy nét	count=6
chụp ảnh ban ngày	count=6
chụp ảnh ban đêm	count=6
chụp ảnh thiếu sáng	count=6
chụp ảnh đủ sáng	count=6
chụp ảnh ngược sáng	count=6
card tích hợp	count=6
chiều rộng	count=6
chế độ chờ	count=6
chế độ lấy nét	count=6
chống nước	count=6
chống xước	count=6
chụp dưới nước	count=6
công nghệ 3d	count=6
cơ chế trượt	count=6
cảm biến tiệm cận	count=6
cảm quang	count=6
cổng esata	count=6
cổng esata/usb	count=6
cổng micro-usb	count=6
dây nguồn	count=6
dây nối	count=6
dạng thanh	count=6
dải iso	count=6
dải màu	count=6
expresscard/34	count=6
giá tiền	count=6
giá thành	count=6
giắc headphone/micro	count=6
góc chụp	count=6
góc trên	count=6
gờ sau	count=6
họa tiết	count=6
khe cắm thẻ mở rộng	count=6
khớp xoay	count=6
kết nối hdmi	count=6
loa trung tâm	count=6
lấy nét tay	count=6
lớp phủ	count=6
màn hình desktop	count=6
màn hình led nền	count=6
màn trập	count=6
màng loa	count=6
mặt đáy	count=6
nghe gọi	count=6
nhiễu hạt	count=6
nắp lưng	count=6
sensor	count=6
sức mạnh đồ họa	count=6
tay cầm	count=6
thanh chịu lực	count=6
thanh cuộn	count=6
truy cập nhanh	count=6
trình nghe nhạc	count=6
trường âm	count=6
trỏ chuột	count=6
tìm kiếm	count=6
tính năng giải trí	count=6
tính thẩm mỹ	count=6
tải dữ liệu	count=6
tải lên	count=6
tấm nền	count=6
tốc độ quét	count=6
vòng xoay chế độ	count=6
vận hành	count=6
xuất hình	count=6
xử lý video	count=6
zoom quang học	count=6
âm thanh stereo	count=6
độ sáng	count=6
đèn nền led	count=6
đèn pin	count=6
ấn tượng	count=6
ổ cứng thể rắn ssd	count=6
bấm số	count=7
bộ nhớ đệm	count=7
chính hãng	count=7
chụp liên tục	count=7
cài đặt	count=7
cảm biến ảnh	count=7
cổng miniusb	count=7
dlna	count=7
dáng dấp	count=7
dáng vẻ	count=7
file video	count=7
hiển thị hình ảnh	count=7
hiệu ứng âm thanh	count=7
hệ thống điều khiển	count=7
kết nối usb	count=7
live view	count=7
lắp đặt	count=7
microusb	count=7
mức độ đen	count=7
ngắm ảnh sống	count=7
nút zoom	count=7
nút điều khiển	count=7
thanh bar	count=7
thanh thông báo	count=7
thị trường	count=7
thời gian chờ	count=7
thời lượng hoạt động	count=7
tiện ích	count=7
tăng giảm âm lượng	count=7
tốc độ lấy nét	count=7
tốc độ quét hình	count=7
vỏ nhôm	count=7
vỏ nhựa	count=7
vỏ nhôm nguyên khối	count=7
vỏ polycarbonat	count=7
vỏ polycarbonat nguyên khối	count=7
xem video trực tuyến	count=7
xử lý hình ảnh	count=7
âm cao	count=7
đa chạm	count=7
đường kính	count=7
đọc/ghi dvd	count=7
độ mỏng	count=7
độ nhạy sáng	count=7
độ sâu	count=7
độ trễ	count=7
ống ngắm	count=7
bàn phím ảo	count=8
băng tần	count=8
bằng nhựa	count=8
bằng kim loại	count=8
bề dày	count=8
bộ nguồn	count=8
bộ sạc	count=8
camera phụ	count=8
camera	count=8
card rời	count=8
chip đồ họa tích hợp	count=8
chân máy	count=8
chịu lực	count=8
cạnh trước	count=8
cảm biến ánh sáng	count=8
cảm nhận	count=8
cấu trúc	count=8
giao tiếp	count=8
giảm nhiễu	count=8
gọi điện thoại	count=8
khe cắm thẻ	count=8
khe cắm thẻ microsd	count=8
khe cắm thẻ sd	count=8
kho ứng dụng	count=8
khử nhiễu	count=8
lịch	count=8
nút chức năng	count=8
sức mạnh	count=8
tay điều khiển	count=8
tinh chỉnh	count=8
trình duyệt web	count=8
tái hiện	count=8
tính năng TimeShift	count=8
timeShift	count=8
tùy biến	count=8
tốc độ hoạt động	count=8
vật liệu	count=8
vỏ nhựa	count=8
vỏ hợp kim cao cấp	count=8
vỏ kim loại	count=8
vỏ kính	count=9
đa nhiệm	count=8
đầu đọc thẻ nhớ sd	count=8
định vị toàn cầu	count=8
độ phân giải tối đa	count=8
độ phóng đại	count=8
bản đồ	count=9
chiều dài	count=9
chế độ chụp ảnh	count=9
chống rung quang học	count=9
công tắc	count=9
cảm ứng điện trở	count=9
cấu hình cơ bản	count=9
cổng microusb	count=9
giải trí đa phương tiện	count=9
giắc cắm headphone	count=9
gõ văn bản	count=9
gờ trước	count=9
hệ thống menu	count=9
kết cấu	count=9
kết nối mạng xã hội	count=9
phím tắt	count=9
trợ sáng	count=9
tuổi thọ	count=9
vẻ ngoài	count=9
zoom số	count=9
âm thanh vòm	count=9
đáp ứng	count=9
đường cong	count=9
đường nét	count=9
định vị toàn cầu gps	count=9
độ nhạy	count=9
độ phân giải gốc	count=9
ổ đĩa quang	count=9
bề ngoài	count=10
bộ xử lý hình ảnh	count=10
chụp tự động	count=10
cổng firewire	count=10
khả năng lưu dữ liệu	count=10
gọi điện video	count=10
khe cắm thẻ nhớ microsd	count=10
khe cắm thẻ nhớ sd	count=10
khả năng xử lý	count=10
loa stereo	count=10
chíp lõi kép	count=10
chíp lõi đơn	count=10
chíp lõi tứ	count=10
cpu lõi kép	count=10
cpu lõi đơn	count=10
cpu lõi tứ	count=10
bộ xử lý lõi kép	count=10
bộ xử lý lõi đơn	count=10
bộ xử lý lõi tứ	count=10
bộ vi xử lý lõi kép	count=10
bộ vi xử lý lõi đơn	count=10
bộ vi xử lý lõi tứ	count=10
micro	count=10
màn gương	count=10
màn hình chính	count=10
màn hình chủ	count=10
mép nàm hình	count=10
mép camera	count=10
mép trái	count=10
mép phải	count=10
mép trên	count=10
mép dưới	count=10
mép máy	count=10
mức trung bình	count=10
nắp đậy	count=10
soạn thảo văn bản	count=10
thao tác	count=10
tấm panel	count=10
xem phim hd	count=10
âm	count=10
đồ họa tích hợp	count=10
độ đen	count=10
băng tần gsm	count=11
chất lượng cuộc gọi	count=11
chỉnh tay	count=11
chụp hình	count=11
chụp macro	count=11
giải trí trực tuyến	count=11
giắc cắm	count=11
hiệu ứng	count=11
không gian lưu trữ	count=11
khả năng đồ họa	count=11
khẩu độ	count=11
menu chính	count=11
mặt trước	count=11
mặt sau	count=11
nguyên khối	count=11
nhận diện khuôn mặt	count=11
phím điều khiển	count=11
quét hình	count=11
quạt làm mát	count=11
sim	count=11
siêu zoom	count=11
soạn thảo	count=11
touch pad	count=11
tốc độ thực thi	count=11
tự động canh nét	count=11
đường viền	count=11
đầu đọc thẻ sd	count=11
độ chi tiết	count=11
độ sắc nét	count=11
bên trong	count=12
bút cảm ứng	count=12
cổng usb 2.0	count=12
e-mail	count=12
firewire	count=12
gsm	count=12
kết nối 3g	count=12
la bàn số	count=12
lõi đơn	count=12
lấy nét tự động	count=12
màu bạc	count=12
thẻ nhớ microsd	count=12
thời gian khởi động	count=12
tiết kiệm điện năng	count=12
điều chỉnh âm lượng	count=12
đài fm	count=12
dải tiêu cự	count=13
mạng xã hội	count=13
nhắn tin	count=13
nút chụp ảnh	count=13
phím nguồn	count=13
phóng to	count=13
vỏ ngoài	count=13
xung nhịp	count=13
xung nhịp chíp xử lý	count=13
xung nhịp chip xử lí	count=13
xung nhịp chíp xử lí	count=13
xung nhịp chip xử lý	count=13
âm bass	count=13
đa phương tiện	count=13
đèn màn hình	count=13
độ tương phản động	count=13
chat	count=14
thiết kế	count=14
thiết kế máy	count=14
chip xử lý	count=14
chíp xử lý	count=14
cạnh bên	count=14
game	count=14
headphone	count=14
khả năng hoạt động	count=14
khả năng chống chầy	count=14
kết nối bluetooth	count=14
kết nối internet	count=14
kết nối không dây	count=14
mức iso	count=14
nút chụp	count=14
phía trước	count=14
pin phụ	count=14
sơn vỏ	count=14
thiết lập	count=14
thời lượng pin	count=14
trackball	count=14
đàm thoại video	count=14
đèn flash led	count=14
độ bền	count=14
ổ đĩa blu-ray	count=14
bàn phím số	count=15
cạnh bên trái	count=15
cạnh bên phải	count=15
viền màn hình cạnh bên trái	count=15
viền màn hình cạnh bên phải	count=15
viền màn hình cạnh bên trên	count=15
viền màn hình cạnh bên dưới	count=15
viền màn hình	count=15
card đồ họa tích hợp	count=15
chống rung	count=15
kết nối mạng	count=15
nhập liệu	count=15
khả năng nhập liệu	count=15
phím cảm ứng	count=15
truy cập	count=15
khả năng truy cập	count=15
tính năng 3d	count=15
tốc độ xử lý	count=15
widget	count=15
a-gps	count=16
cảm ứng điện dung	count=16
dáng	count=16
gprs	count=16
nhiệt độ	count=16
phụ kiện	count=16
đàm thoại	count=16
đèn nền	count=16
độ dày	count=16
độ nảy	count=16
cải tiến	count=17
đa điểm	count=17
ứng dụng văn phòng	count=17
bàn phím chiclet	count=18
dải zoom	count=18
gọi điện	count=18
hình thức	count=18
màn hình led	count=18
nút nguồn	count=18
phong cách	count=18
phía trên	count=18
tùy chọn	count=18
ảnh chụp	count=18
danh bạ	count=19
khe cắm	count=19
phần cứng	count=19
xem ảnh	count=19
đáy	count=19
độ nét	count=19
chất lượng ảnh	count=20
hình dáng	count=20
mặt trên	count=20
phân giải	count=20
phía dưới	count=20
phím chức năng	count=20
quay phim hd	count=20
tin nhắn	count=20
vỏ máy	count=20
âm trầm	count=20
ghi âm	count=21
khung hình	count=21
màn hình lcd	count=21
màn hình clearback	count=21
trackpad	count=21
chơi nhạc	count=22
cuộc gọi	count=22
cảm ứng đa điểm	count=22
icon	count=22
phía sau	count=22
thông số kỹ thuật	count=22
thời gian sử dụng	count=22
tiếng bass	count=22
đầu đọc thẻ nhớ	count=22
ổ cứng hdd	count=22
ổ ghi dvd	count=22
cổng vga	count=23
làm việc	count=23
microphone	count=23
trình diễn	count=23
tự động lấy nét	count=23
định dạng	count=23
khe cắm thẻ nhớ	count=24
thực thi	count=24
tiêu cự	count=24
tùy chỉnh	count=24
đèn led nền	count=24
chụp liên tiếp	count=25
giá thành	count=25
giắc cắm	count=25
màn hình home	count=25
nâng cấp	count=25
cổng giao tiếp	count=26
ngoại hình	count=26
tắt	count=26
bộ khung	count=27
cạnh bên	count=27
nhiễu	count=27
đánh giá	count=27
khung máy	count=28
khung nhôm	count=3
khả năng nghe nhạc	count=3
trình quản lý nhạc	count=3
trình quản lý phim	count=3
trình quản lý điện năng	count=3
trình quản lý pin	count=3
trình quản lý âm thanh	count=3
trình nghe nhạc	count=3
nút bấm	count=28
thân hình	count=28
vị trí nút bấm	count=28
vị trí nút home	count=28
vị trí phím bấm	count=28
vị trí phím home	count=28
vị trí nút tăng giảm âm lượng	count=28
vị trí phím tăng giảm âm lượng	count=28
vị trí nút nguồn	count=28
vị trí phím nguồn	count=28
vị trí nút camera	count=28
vị trí nút chụp ảnh	count=28
vị trí phím camera	count=28
vị trí phím chụp ảnh	count=28
chất lượng hình ảnh	count=29
cân bằng trắng	count=29
duyệt web	count=29
hiệu suất	count=29
kết nối wi-fi	count=29
tự động	count=29
chất lượng âm thanh	count=30
chức năng	count=30
hiệu suất hoạt động	count=30
bàn phím qwerty	count=31
chương trình duyệt web	count=31
chương trình nghe nhạc	count=31
chương trình xem phim	count=31
chương trình đọc sách	count=31
chương trình chơi game	count=31
chương trình chụp ảnh	count=31
công suất	count=31
máy ảnh	count=31
sạc	count=31
sạc không dây	count=31
xem video	count=31
đèn led	count=31
khả năng thực thi	count=32
màn hình gương	count=32
phím chuột	count=32
đèn flash	count=33
phím điều hướng	count=33
bộ loa	count=34
hệ thống loa	count=34
cân nặng	count=35
menu	count=35
trình duyệt	count=35
ổ quang	count=35
khởi động	count=36
phiên bản	count=36
phần mềm	count=36
3g	count=37
lớp vỏ	count=38
thân máy	count=38
xử lý	count=38
bộ xử lý	count=39
chip	count=39
chất liệu	count=39
thông số	count=39
nắp máy	count=40
hsdpa	count=41
lấy nét	count=42
chế tạo	count=42
chip đồ họa	count=43
chơi game	count=43
kích cỡ	count=43
cpu	count=44
cạnh trái	count=44
tai nghe	count=44
zoom quang	count=44
đồ họa	count=44
âm lượng	count=45
bộ nhớ trong	count=47
gps	count=47
loa ngoài	count=47
tản nhiệt	count=47
video	count=47
cạnh phải	count=49
giải trí	count=50
độ tương phản	count=51
điều khiển	count=52
thẻ nhớ	count=53
hdmi	count=54
webcam	count=54
bộ nhớ	count=55
góc nhìn	count=57
mức giá	count=59
chất lượng hiển thị	count=59
xem phim	count=59
bộ nhớ ram	count=60
bộ vi xử lý	count=61
công nghệ	count=61
công nghệ ClearBack	count=61
công nghệ Retina	count=61
công nghệ chế tạo	count=61
công nghệ chụp ảnh	count=61
công nghệ sản xuất	count=61
công nghệ chụp ảnh Pureview	count=61
công nghệ cảm ứng	count=61
giắc cắm tai nghe	count=61
cổng hdmi	count=63
cảm giác bấm phím	count=64
cảm giác cầm nắm	count=64
cảm giác cầm	count=64
cảm giác sử dụng	count=64
cảm giác chụp ảnh	count=64
cảm giác quay phim	count=64
cảm giác rỗ của màn hình	count=64
quay phim	count=67
nút bấm	count=70
bề mặt	count=74
hỗ trợ	count=75
cảm biến	count=76
quay video	count=78
cảm ứng	count=81
cổng kết nối	count=81
định vị gps	count=81
nghe nhạc	count=83
chụp tối	count=86
chụp ngày	count=86
chụp ban ngày	count=86
chụp ban đêm	count=86
loa thoại	count=86
phím bấm	count=86
kiểu dáng	count=92
bluetooth 2.0	count=93
lướt web	count=93
ứng dụng	count=97
ứng dụng chụp ảnh	count=97
ứng dụng nghe nhạc	count=97
ứng dụng chơi nhạc	count=97
ứng dụng bảo mật	count=97
ứng dụng chơi video	count=97
ứng dụng xem video	count=97
ứng dụng xem phim	count=97
hiệu năng	count=100
sử dụng	count=102
chạy ứng dụng	count=104
dung lượng	count=113
dung lượng bộ nhớ	count=113
thời lượng	count=115
thời lượng pin	count=115
hiển thị	count=116
ram	count=126
phím	count=127
trọng lượng	count=135
hoạt động	count=142
chụp ảnh	count=143
cổng usb	count=159
ống kính	count=160
vỏ	count=169
hệ điều hành	count=177
giao diện	count=198
touchpad	count=198
âm thanh	count=206
cấu hình	count=230
tính năng	count=243
hình ảnh chụp	count=262
hình ảnh màn hình	count=262
kích thước	count=310
tốc độ	count=315
chất lượng	count=319
độ phân giải	count=387
độ phân giải màn hình	count=387
pin	count=581
màn hình retina	count=978
khả năng chụp hình	count=978
khả năng chụp ảnh	count=978
kích cỡ của các nút	count=978
bên trên	count=4
củ sạc	count=4
cục sạc	count=4
bluetooth	count=3
camera chụp tối	count=3
camera ban ngày	count=3
chế tạo	count=3
camera Ultrapixel chụp tối	count=3
camera Ultrapixel	count=3
chụp tối	count=3
độ méo tiếng	count=3
kiểm soát loa	count=3
loa điện thoại	count=3
tính năng bổ sung	count=3
chất lượng ảnh trong môi trường thiếu sáng	count=3
chất lượng ảnh trong môi trường sáng yếu	count=3
smartphone	count=3
chiếc điện thoại	count=3