tác hại	polarity=NEGATIVE
tắc trách	polarity=NEGATIVE
tài ba	polarity=POSITIVE
tài hoa	polarity=POSITIVE
tái mét	polarity=NEGATIVE
tai nạn	polarity=NEGATIVE
tai nạn chết người	polarity=NEGATIVE
tai nạn giao thông	polarity=NEGATIVE
tai nạn lao động	polarity=NEGATIVE
tai nạn máy bay	polarity=NEGATIVE
tai nạn xe cộ	polarity=NEGATIVE
tai nạn xe hơi	polarity=NEGATIVE
tái ngắt	polarity=NEGATIVE
tái phạm	polarity=NEGATIVE
tai quái	polarity=NEGATIVE
tái sinh	polarity=POSITIVE
tài tình	polarity=POSITIVE
tầm bậy	polarity=NEGATIVE
tâm đầu ý hợp	polarity=POSITIVE
tâm điểm	polarity=POSITIVE
tạm giữ	polarity=NEGATIVE
tâm huyết	polarity=POSITIVE
tàn ác	polarity=NEGATIVE
tàn bạo	polarity=NEGATIVE
tận cùng	polarity=NEGATIVE
tàn nhẫn	polarity=NEGATIVE
tán thưởng	polarity=POSITIVE
tan vỡ	polarity=NEGATIVE
tâng bốc	polarity=NEGATIVE
tăng giá	polarity=NEGATIVE
táng tận lương tâm	polarity=NEGATIVE
tang tóc	polarity=NEGATIVE
tanh hôi	polarity=NEGATIVE
táo bạo	polarity=POSITIVE
tạo điều kiện	polarity=POSITIVE
tẩy chay	polarity=NEGATIVE
tệ hại	polarity=NEGATIVE
tê liệt	polarity=NEGATIVE
thái quá	polarity=NEGATIVE
thảm hại	polarity=NEGATIVE
thảm họa	polarity=NEGATIVE
tham nhũng	polarity=NEGATIVE
tham ô	polarity=NEGATIVE
thần kỳ	polarity=POSITIVE
than phiền	polarity=NEGATIVE
thán phục	polarity=POSITIVE
thân thiện	polarity=POSITIVE
thân thiết	polarity=POSITIVE
thân yêu	polarity=POSITIVE
thắng lợi	polarity=POSITIVE
thắng lợi giòn giã	polarity=POSITIVE
thắng lợi to lớn	polarity=POSITIVE
thẳng thắn	polarity=POSITIVE
thăng tiến	polarity=POSITIVE
thanh bạch	polarity=POSITIVE
thanh bình	polarity=POSITIVE
thành công	polarity=POSITIVE
thanh lịch	polarity=POSITIVE
thanh nhã	polarity=POSITIVE
thanh thản	polarity=POSITIVE
thành thạo	polarity=POSITIVE
thành thục	polarity=POSITIVE
thanh tú	polarity=POSITIVE
thất bại	polarity=NEGATIVE
thất bại cay đắng	polarity=NEGATIVE
thất bại liểng xiểng	polarity=NEGATIVE
thất bại nặng nề	polarity=NEGATIVE
thất nghiệp	polarity=NEGATIVE
thật sự	polarity=POSITIVE
thất thoát	polarity=NEGATIVE
thất thường	polarity=NEGATIVE
thất vọng	polarity=NEGATIVE
thế bất lợi	polarity=NEGATIVE
then chốt	polarity=POSITIVE
thích đáng	polarity=POSITIVE
thích hợp	polarity=POSITIVE
thích thú	polarity=POSITIVE
thiển cận	polarity=NEGATIVE
thiên phú	polarity=POSITIVE
thiệt hại	polarity=NEGATIVE
thiệt hại khó tránh	polarity=NEGATIVE
thiệt hại thực tế	polarity=NEGATIVE
thiệt thòi	polarity=NEGATIVE
thiết thực	polarity=POSITIVE
thiết yếu	polarity=POSITIVE
thiếu hụt	polarity=NEGATIVE
thiểu não	polarity=NEGATIVE
thiếu ngủ	polarity=NEGATIVE
thiếu sữa	polarity=NEGATIVE
thiếu thốn	polarity=NEGATIVE
thiếu tinh thần trách nhiệm	polarity=NEGATIVE
thịnh vượng	polarity=POSITIVE
thiu	polarity=NEGATIVE
thiu thối	polarity=NEGATIVE
thô bạo	polarity=NEGATIVE
thô tục	polarity=NEGATIVE
thoải mái	polarity=POSITIVE
thối nát	polarity=NEGATIVE
thối rữa	polarity=NEGATIVE
thối tha	polarity=NEGATIVE
thối thây	polarity=NEGATIVE
thói xấu khỏi dạy cũng biết	polarity=NEGATIVE
thơm nức	polarity=POSITIVE
thơm phức	polarity=POSITIVE
thong manh	polarity=NEGATIVE
thông minh	polarity=POSITIVE
thông thoáng	polarity=POSITIVE
thông tuệ	polarity=POSITIVE
thụ động	polarity=NEGATIVE
thư giãn	polarity=POSITIVE
thu hồi	polarity=NEGATIVE
thú nhận	polarity=NEGATIVE
thú vị	polarity=POSITIVE
thua đậm	polarity=NEGATIVE
thua lỗ	polarity=NEGATIVE
thuận	polarity=POSITIVE
thuần khiết	polarity=POSITIVE
thuận lợi	polarity=POSITIVE
thuận tiện	polarity=POSITIVE
thực hiện đúng	polarity=POSITIVE
thuốc chống ung thư	polarity=POSITIVE
thượng hạng	polarity=POSITIVE
thượng hảo hạng	polarity=POSITIVE
thương tâm	polarity=NEGATIVE
tỉ mỉ	polarity=POSITIVE
ti tiện	polarity=NEGATIVE
tích cực	polarity=POSITIVE
tích cực tham gia	polarity=POSITIVE
tiếc rằng	polarity=NEGATIVE
tiến bộ	polarity=POSITIVE
tiện lợi	polarity=POSITIVE
tiền mất tật mang	polarity=NEGATIVE
tiện nghi	polarity=POSITIVE
tiên tiến	polarity=POSITIVE
tiếp tay	polarity=NEGATIVE
tiết kiệm	polarity=POSITIVE
tiêu thụ được	polarity=POSITIVE
tinh khiết	polarity=POSITIVE
tinh luyện	polarity=POSITIVE
tinh tế	polarity=POSITIVE
tinh xảo	polarity=POSITIVE
tinh ý	polarity=NEGATIVE
tố cáo	polarity=NEGATIVE
to lớn	polarity=POSITIVE
tỏa sáng	polarity=POSITIVE
toàn diện	polarity=POSITIVE
toàn thắng	polarity=POSITIVE
tồi	polarity=NEGATIVE
tội lỗi	polarity=NEGATIVE
tối tân	polarity=POSITIVE
tồi tệ	polarity=NEGATIVE
tối ưu	polarity=POSITIVE
tởm lợm	polarity=NEGATIVE
tổn hại	polarity=NEGATIVE
tôn kính	polarity=POSITIVE
tổn thương	polarity=NEGATIVE
tôn vinh	polarity=POSITIVE
tống tiền	polarity=NEGATIVE
tốt	polarity=POSITIVE
tốt đẹp	polarity=POSITIVE
tốt sữa	polarity=POSITIVE
tốt tươi	polarity=POSITIVE
tra tấn	polarity=NEGATIVE
trả thù	polarity=NEGATIVE
trắc trở	polarity=NEGATIVE
trái phép	polarity=NEGATIVE
trai trẻ	polarity=POSITIVE
trầm cảm	polarity=NEGATIVE
trầm trọng	polarity=NEGATIVE
trang trọng	polarity=POSITIVE
tranh chấp	polarity=NEGATIVE
tranh giành quyền lợi	polarity=NEGATIVE
trầy trật	polarity=NEGATIVE
trẻ trung	polarity=POSITIVE
trơ tráo	polarity=NEGATIVE
trộm	polarity=NEGATIVE
trộm cắp	polarity=NEGATIVE
trong sạch	polarity=POSITIVE
trong sáng	polarity=POSITIVE
trọng thương	polarity=NEGATIVE
trù phú	polarity=POSITIVE
trữ tình	polarity=POSITIVE
trục lợi	polarity=NEGATIVE
trúc trắc	polarity=NEGATIVE
trục trặc	polarity=NEGATIVE
trung dũng	polarity=POSITIVE
trừng phạt	polarity=NEGATIVE
trung thành	polarity=POSITIVE
trung thực	polarity=POSITIVE
trưởng thành	polarity=POSITIVE
trường thọ	polarity=POSITIVE
trụy lạc	polarity=NEGATIVE
truy nã	polarity=NEGATIVE
truy tố	polarity=NEGATIVE
tự hào	polarity=POSITIVE
tử nạn	polarity=NEGATIVE
tự nhiên	polarity=POSITIVE
tự phát	polarity=NEGATIVE
tự sát	polarity=NEGATIVE
tử tế	polarity=POSITIVE
tự ti	polarity=NEGATIVE
tự tin	polarity=POSITIVE
tự tử	polarity=NEGATIVE
tử vong	polarity=NEGATIVE
tục tĩu	polarity=NEGATIVE
tủi nhục	polarity=NEGATIVE
tưng bừng	polarity=POSITIVE
túng quẫn	polarity=NEGATIVE
túng thiếu	polarity=NEGATIVE
tươi	polarity=POSITIVE
tươi sáng	polarity=POSITIVE
tươi tắn	polarity=POSITIVE
tương thích	polarity=POSITIVE
tùy tiện	polarity=NEGATIVE
tuyệt chủng	polarity=NEGATIVE
tuyệt đối	polarity=POSITIVE
tuyệt vời	polarity=POSITIVE
tuyệt vọng	polarity=NEGATIVE
uể oải	polarity=NEGATIVE
uế tạp	polarity=NEGATIVE
ùn tắc	polarity=NEGATIVE
ủng hộ	polarity=POSITIVE
ương bướng	polarity=NEGATIVE
ưu tú	polarity=POSITIVE
ưu việt	polarity=POSITIVE
uy hiếp	polarity=NEGATIVE
uyển chuyển	polarity=POSITIVE
uyên thâm	polarity=POSITIVE
váng	polarity=NEGATIVE
vắng mặt không phép	polarity=NEGATIVE
vàng vọt	polarity=NEGATIVE
vất vả	polarity=NEGATIVE
vết bẩn	polarity=NEGATIVE
vĩ đại	polarity=POSITIVE
vi phạm	polarity=NEGATIVE
vị tha	polarity=NEGATIVE
viển vông	polarity=NEGATIVE
vinh quang	polarity=POSITIVE
vô bổ	polarity=NEGATIVE
vô cớ	polarity=NEGATIVE
vô địch	polarity=POSITIVE
vô dụng	polarity=NEGATIVE
vô duyên	polarity=NEGATIVE
vô giáo dục	polarity=NEGATIVE
vô liêm sỉ	polarity=NEGATIVE
vô lối	polarity=NEGATIVE
vô lương tâm	polarity=NEGATIVE
vô lý	polarity=NEGATIVE
vô nguyên tắc	polarity=NEGATIVE
vô sinh	polarity=NEGATIVE
vô ý	polarity=NEGATIVE
vụ bê bối	polarity=NEGATIVE
vụ lợi	polarity=NEGATIVE
vừa đủ	polarity=POSITIVE
vừa ý	polarity=POSITIVE
vui nhộn	polarity=POSITIVE
vui sướng	polarity=POSITIVE
vui tươi	polarity=POSITIVE
vui vẻ	polarity=POSITIVE
vững	polarity=POSITIVE
vững bền	polarity=POSITIVE
vững chắc	polarity=POSITIVE
vững chãi	polarity=POSITIVE
vụng trộm	polarity=NEGATIVE
vững vàng	polarity=POSITIVE
xa xỉ	polarity=NEGATIVE
xâm lược	polarity=NEGATIVE
xâm phạm	polarity=NEGATIVE
xấu	polarity=NEGATIVE
xấu bụng	polarity=NEGATIVE
xấu hổ	polarity=NEGATIVE
xấu tính	polarity=NEGATIVE
xấu xa	polarity=NEGATIVE
xấu xí	polarity=NEGATIVE
xịn	polarity=POSITIVE
xinh	polarity=POSITIVE
xinh đẹp	polarity=POSITIVE
xinh xắn	polarity=POSITIVE
xóa đói giảm nghèo	polarity=POSITIVE
xoàng xĩnh	polarity=NEGATIVE
xốc xếch	polarity=NEGATIVE
xộc xệch	polarity=NEGATIVE
xử	polarity=NEGATIVE
xuất sắc	polarity=POSITIVE
xúc động	polarity=POSITIVE
xúc phạm	polarity=NEGATIVE
xứng đáng	polarity=POSITIVE
xuống cấp	polarity=NEGATIVE
xuyên tạc	polarity=NEGATIVE
yên bình	polarity=POSITIVE
yên lòng	polarity=POSITIVE
yên tâm	polarity=POSITIVE
yên tĩnh	polarity=POSITIVE
yếu	polarity=NEGATIVE
yêu chuộng	polarity=POSITIVE
yêu đời	polarity=POSITIVE
yếu đuối	polarity=NEGATIVE
yếu hèn	polarity=NEGATIVE
yếu kém	polarity=NEGATIVE
yêu nước	polarity=POSITIVE
yêu quý	polarity=POSITIVE
yêu thích	polarity=POSITIVE
ác liệt	polarity=NEGATIVE
ác tính	polarity=NEGATIVE
ấm	polarity=POSITIVE
ấm áp	polarity=POSITIVE
ấm cúng	polarity=POSITIVE
ảm đạm	polarity=NEGATIVE
ám sát	polarity=NEGATIVE
ăn bẩn	polarity=NEGATIVE
ăn cắp	polarity=NEGATIVE
an toàn	polarity=POSITIVE
ăn trộm	polarity=NEGATIVE
ảo	polarity=NEGATIVE
ấu trĩ	polarity=NEGATIVE
ba lăng nhăng	polarity=NEGATIVE
bẩn	polarity=NEGATIVE
bán chạy	polarity=POSITIVE
bán dâm	polarity=NEGATIVE
băn khoăn	polarity=NEGATIVE
bận rộn	polarity=NEGATIVE
bẩn thỉu	polarity=NEGATIVE
bần tiện	polarity=NEGATIVE
bẳn tính	polarity=NEGATIVE
bẩn tưởi	polarity=NEGATIVE
báo động	polarity=NEGATIVE
bạo động	polarity=NEGATIVE
bao dung	polarity=POSITIVE
bắt	polarity=NEGATIVE
bất bình	polarity=NEGATIVE
bất chính	polarity=NEGATIVE
bắt cóc	polarity=NEGATIVE
bất công	polarity=NEGATIVE
bất đồng	polarity=NEGATIVE
bất hạnh	polarity=NEGATIVE
bất hiếu	polarity=NEGATIVE
bất hợp lý	polarity=NEGATIVE
bất hợp pháp	polarity=NEGATIVE
bắt khẩn cấp	polarity=NEGATIVE
bất lợi	polarity=NEGATIVE
bất lực	polarity=NEGATIVE
bất mãn	polarity=NEGATIVE
bất ngờ	polarity=POSITIVE
bất ổn	polarity=NEGATIVE
bắt quả tang	polarity=NEGATIVE
bất thường	polarity=NEGATIVE
bất trắc	polarity=NEGATIVE
bê bối	polarity=NEGATIVE
bé hạt tiêu	polarity=POSITIVE
bế tắc	polarity=NEGATIVE
bền	polarity=POSITIVE
bền vững	polarity=POSITIVE
bệnh hoạn	polarity=NEGATIVE
béo	polarity=NEGATIVE
béo phì	polarity=NEGATIVE
bị thương	polarity=NEGATIVE
bị tình nghi	polarity=NEGATIVE
bị trộm	polarity=NEGATIVE
bịa	polarity=NEGATIVE
bịa chuyện	polarity=NEGATIVE
bịa đặt	polarity=NEGATIVE
bịa tạc	polarity=NEGATIVE
biết việc	polarity=POSITIVE
biểu tình	polarity=NEGATIVE
bình an	polarity=POSITIVE
bình phục	polarity=POSITIVE
bình tĩnh	polarity=POSITIVE
bịp bợm	polarity=NEGATIVE
bịt	polarity=NEGATIVE
bịt đầu mối	polarity=NEGATIVE
bổ huyết	polarity=POSITIVE
bổ phổi	polarity=POSITIVE
bổ thận	polarity=POSITIVE
bốc đồng	polarity=NEGATIVE
bốc lửa	polarity=POSITIVE
bốc mùi	polarity=NEGATIVE
bốc phét	polarity=NEGATIVE
bôi bẩn	polarity=NEGATIVE
bối rối	polarity=NEGATIVE
bồi thường	polarity=NEGATIVE
bóp chết	polarity=NEGATIVE
bóp chẹt	polarity=NEGATIVE
bóp méo	polarity=NEGATIVE
bừa bãi	polarity=NEGATIVE
bức bối	polarity=NEGATIVE
bực bội	polarity=NEGATIVE
bực mình	polarity=NEGATIVE
bức xúc	polarity=NEGATIVE
buộc tội	polarity=NEGATIVE
buồn	polarity=NEGATIVE
buồn bã	polarity=NEGATIVE
buồn hiu hắt	polarity=NEGATIVE
buôn lậu	polarity=NEGATIVE
buồn nôn	polarity=NEGATIVE
buồn tẻ	polarity=NEGATIVE
ca ngợi	polarity=POSITIVE
cách chức	polarity=NEGATIVE
cãi nhau	polarity=NEGATIVE
cải thiện	polarity=POSITIVE
cải tiến	polarity=POSITIVE
cấm	polarity=NEGATIVE
cảm động	polarity=POSITIVE
cam kết	polarity=POSITIVE
cảm lạnh	polarity=NEGATIVE
cảm ơn	polarity=POSITIVE
can đảm	polarity=POSITIVE
cân đối	polarity=POSITIVE
cẩn thận	polarity=POSITIVE
cận thị	polarity=NEGATIVE
căng thẳng	polarity=NEGATIVE
cảnh cáo	polarity=NEGATIVE
cảnh giác	polarity=NEGATIVE
cao cả	polarity=POSITIVE
cao cấp	polarity=POSITIVE
cao huyết áp	polarity=NEGATIVE
cao quý	polarity=POSITIVE
cập rập	polarity=NEGATIVE
cay	polarity=NEGATIVE
cay đắng	polarity=NEGATIVE
cay độc	polarity=NEGATIVE
chậm	polarity=NEGATIVE
chậm chạp	polarity=NEGATIVE
chăm chỉ	polarity=POSITIVE
chăm sóc	polarity=POSITIVE
chậm tiến	polarity=NEGATIVE
chậm trễ	polarity=NEGATIVE
chấn chỉnh	polarity=POSITIVE
chần chừ	polarity=NEGATIVE
chần chừ khiến lãng phí thời gian	polarity=NEGATIVE
chán nản	polarity=NEGATIVE
chán ngắt	polarity=NEGATIVE
chân thành	polarity=POSITIVE
chập chà chập chờn	polarity=POSITIVE
chập chờn	polarity=POSITIVE
chật vật	polarity=NEGATIVE
chảy máu	polarity=NEGATIVE
chê	polarity=NEGATIVE
che giấu	polarity=NEGATIVE
chém	polarity=NEGATIVE
chết	polarity=NEGATIVE
chết chóc	polarity=NEGATIVE
chỉ trích	polarity=NEGATIVE
chiếm đoạt	polarity=NEGATIVE
chiếm dụng	polarity=NEGATIVE
chiếm ưu thế	polarity=POSITIVE
chiến thắng	polarity=POSITIVE
chín chắn	polarity=POSITIVE
chinh phục	polarity=POSITIVE
chính quy	polarity=POSITIVE
chỉnh tề	polarity=POSITIVE
chính xác	polarity=POSITIVE
choáng	polarity=NEGATIVE
chông gai	polarity=NEGATIVE
chu đáo	polarity=POSITIVE
chú trọng	polarity=POSITIVE
chua	polarity=NEGATIVE
chưa chắc	polarity=NEGATIVE
chua xót	polarity=NEGATIVE
chuẩn	polarity=POSITIVE
chuẩn xác	polarity=POSITIVE
chung thủy	polarity=POSITIVE
chuyên nghiệp	polarity=POSITIVE
có điều kiện	polarity=POSITIVE
cô đơn	polarity=NEGATIVE
cơ động	polarity=POSITIVE
có duyên	polarity=POSITIVE
có giáo dục	polarity=POSITIVE
có hiệu quả	polarity=POSITIVE
có ích	polarity=POSITIVE
cơ yếu	polarity=POSITIVE
cởi mở	polarity=POSITIVE
coi thường	polarity=NEGATIVE
còi xương	polarity=NEGATIVE
công phu	polarity=POSITIVE
cực chẳng đã	polarity=NEGATIVE
cực khổ	polarity=NEGATIVE
cực kỳ	polarity=POSITIVE
cực thịnh	polarity=POSITIVE
cực tốt	polarity=POSITIVE
cứng	polarity=NEGATIVE
cứng cỏi	polarity=POSITIVE
cứng nhắc	polarity=NEGATIVE
cười ra nước mắt	polarity=NEGATIVE
cường tráng	polarity=POSITIVE
cướp	polarity=NEGATIVE
cụt hứng	polarity=NEGATIVE
đa dạng	polarity=POSITIVE
dã man	polarity=NEGATIVE
đa năng	polarity=POSITIVE
đắc địa	polarity=POSITIVE
đắc lực	polarity=POSITIVE
đặc sắc	polarity=POSITIVE
dại dột	polarity=NEGATIVE
đâm	polarity=NEGATIVE
đậm	polarity=POSITIVE
đậm đà	polarity=POSITIVE
đẫm máu	polarity=NEGATIVE
đam mê	polarity=POSITIVE
dâm ô	polarity=NEGATIVE
đằm thắm	polarity=POSITIVE
dàn xếp	polarity=NEGATIVE
đáng báo động	polarity=NEGATIVE
đáng ca ngợi	polarity=POSITIVE
đáng chú ý	polarity=POSITIVE
dang dở	polarity=NEGATIVE
đáng ghét	polarity=NEGATIVE
đàng hoàng	polarity=POSITIVE
đáng khen	polarity=POSITIVE
đáng kính	polarity=POSITIVE
đáng lo ngại	polarity=NEGATIVE
đáng sợ	polarity=NEGATIVE
đáng tiếc	polarity=NEGATIVE
đáng tiền	polarity=POSITIVE
đáng tin cậy	polarity=POSITIVE
đáng yêu	polarity=POSITIVE
đánh đập	polarity=NEGATIVE
đánh mất	polarity=NEGATIVE
đảo chính	polarity=NEGATIVE
đắt	polarity=NEGATIVE
đắt đỏ	polarity=NEGATIVE
đắt giá	polarity=POSITIVE
đắt khách	polarity=POSITIVE
đạt tiêu chuẩn	polarity=POSITIVE
đau	polarity=NEGATIVE
đau đớn	polarity=NEGATIVE
đau khổ	polarity=NEGATIVE
đau lòng	polarity=NEGATIVE
đau nhức	polarity=NEGATIVE
đáy	polarity=NEGATIVE
đẩy mạnh	polarity=POSITIVE
đầy mâu thuẫn	polarity=NEGATIVE
dễ bị cảm	polarity=NEGATIVE
dễ chịu	polarity=POSITIVE
dễ dãi	polarity=NEGATIVE
dễ dàng	polarity=POSITIVE
đe dọa	polarity=NEGATIVE
dễ dùng	polarity=POSITIVE
dễ hiểu	polarity=POSITIVE
để lọt	polarity=NEGATIVE
dễ sử dụng	polarity=POSITIVE
dễ thương	polarity=POSITIVE
dễ vỡ	polarity=NEGATIVE
đền bù	polarity=NEGATIVE
đến nỗi	polarity=NEGATIVE
dẻo dai	polarity=POSITIVE
đẹp	polarity=POSITIVE
đẹp đẽ	polarity=POSITIVE
đẹp đôi	polarity=POSITIVE
đẹp duyên	polarity=POSITIVE
đẹp mắt	polarity=POSITIVE
đẹp nõn nà	polarity=POSITIVE
đẹp quyến rũ	polarity=POSITIVE
đẹp trai	polarity=POSITIVE
đẹp tuyệt	polarity=POSITIVE
đi chệch	polarity=NEGATIVE
dị dạng	polarity=NEGATIVE
dị vật	polarity=NEGATIVE
địa ngục	polarity=NEGATIVE
địa ngục trần gian	polarity=NEGATIVE
dịch bệnh	polarity=NEGATIVE
đích thực	polarity=POSITIVE
điên	polarity=NEGATIVE
diễn cảm	polarity=POSITIVE
điên lên	polarity=NEGATIVE
điều bất lợi	polarity=NEGATIVE
điều độ	polarity=POSITIVE
điêu đứng	polarity=NEGATIVE
điều khó chịu	polarity=NEGATIVE
điều kiện thuận lợi	polarity=POSITIVE
điêu luyện	polarity=POSITIVE
đỉnh cao	polarity=POSITIVE
đình chỉ	polarity=NEGATIVE
đình đám	polarity=POSITIVE
dịu dàng	polarity=POSITIVE
đìu hiu	polarity=NEGATIVE
dở	polarity=NEGATIVE
dơ bẩn	polarity=NEGATIVE
dở dang	polarity=NEGATIVE
độ nét cao	polarity=POSITIVE
đổ vỡ	polarity=NEGATIVE
đoạt giải	polarity=POSITIVE
độc đáo	polarity=POSITIVE
độc hại	polarity=NEGATIVE
độc quyền	polarity=NEGATIVE
đồi bại	polarity=NEGATIVE
dồi dào	polarity=POSITIVE
đổi mới	polarity=POSITIVE
đồi trụy	polarity=NEGATIVE
đông đúc	polarity=NEGATIVE
dốt đặc cán mai	polarity=NEGATIVE
dốt nát	polarity=NEGATIVE
đột nhập	polarity=NEGATIVE
đột phá	polarity=POSITIVE
dữ dội	polarity=NEGATIVE
đủ sức	polarity=POSITIVE
đủ sức khỏe	polarity=POSITIVE
đủ tài	polarity=POSITIVE
đủ tiêu chuẩn	polarity=POSITIVE
đục nước béo cò	polarity=NEGATIVE
dũng cảm	polarity=POSITIVE
đúng đắn	polarity=POSITIVE
đứng đắn	polarity=POSITIVE
đúng giá	polarity=POSITIVE
đúng giờ	polarity=POSITIVE
đúng hạn	polarity=POSITIVE
đúng lúc	polarity=POSITIVE
dũng mãnh	polarity=POSITIVE
được việc	polarity=POSITIVE
đuối hơi	polarity=NEGATIVE
đuối lý	polarity=NEGATIVE
đuối sức	polarity=NEGATIVE
duy nhất	polarity=POSITIVE
duyên dáng	polarity=POSITIVE
ế ẩm	polarity=NEGATIVE
e ngại	polarity=NEGATIVE
ế thiu	polarity=NEGATIVE
êm	polarity=POSITIVE
êm ái	polarity=POSITIVE
êm đềm	polarity=POSITIVE
êm đẹp	polarity=POSITIVE
ép buộc	polarity=NEGATIVE
gánh chịu	polarity=NEGATIVE
gạo cội	polarity=POSITIVE
gặp khó khăn	polarity=NEGATIVE
gây án	polarity=NEGATIVE
gây bệnh	polarity=NEGATIVE
gay gắt	polarity=NEGATIVE
gây mất mát	polarity=NEGATIVE
gây ra	polarity=NEGATIVE
gây rối	polarity=NEGATIVE
gầy yếu	polarity=NEGATIVE
ghê gớm	polarity=NEGATIVE
ghẻ lạnh	polarity=NEGATIVE
già	polarity=NEGATIVE
giả	polarity=NEGATIVE
giả mạo	polarity=NEGATIVE
giả tạo	polarity=NEGATIVE
giải độc	polarity=POSITIVE
giảm giá	polarity=POSITIVE
giảm sút	polarity=NEGATIVE
giảm thuế	polarity=POSITIVE
giản dị	polarity=POSITIVE
gián đoạn	polarity=NEGATIVE
giận dữ	polarity=NEGATIVE
gian khổ	polarity=NEGATIVE
gian lận	polarity=NEGATIVE
gian nan	polarity=NEGATIVE
gian tà	polarity=NEGATIVE
gian tham	polarity=NEGATIVE
giàu	polarity=POSITIVE
giàu có	polarity=POSITIVE
giết	polarity=NEGATIVE
giết chết	polarity=NEGATIVE
giết người	polarity=NEGATIVE
giết người cướp của	polarity=NEGATIVE
giỏi	polarity=POSITIVE
gợi cảm	polarity=POSITIVE
gọn	polarity=POSITIVE
gọn gàng	polarity=POSITIVE
gọn ghẽ	polarity=POSITIVE
gọn nhẹ	polarity=POSITIVE
hà tiện	polarity=NEGATIVE
hài hòa	polarity=POSITIVE
hài hước	polarity=POSITIVE
hài lòng	polarity=POSITIVE
hám lợi	polarity=NEGATIVE
hàng đầu	polarity=POSITIVE
hàng giả	polarity=NEGATIVE
hạng nhất	polarity=POSITIVE
hành hạ	polarity=NEGATIVE
hạnh phúc	polarity=POSITIVE
hảo hạng	polarity=POSITIVE
hào hiệp	polarity=POSITIVE
hào nhoáng	polarity=NEGATIVE
hào phóng	polarity=POSITIVE
hào sảng	polarity=POSITIVE
hấp dẫn	polarity=POSITIVE
hấp tấp	polarity=POSITIVE
hậu đậu	polarity=NEGATIVE
hèn mọn	polarity=NEGATIVE
hẹp hòi	polarity=NEGATIVE
hết hạn	polarity=NEGATIVE
hết thời	polarity=NEGATIVE
hiếm có	polarity=POSITIVE
hiếm muộn	polarity=NEGATIVE
hiện đại	polarity=POSITIVE
hiển hách	polarity=POSITIVE
hiền hậu	polarity=POSITIVE
hiền lành	polarity=POSITIVE
hiu hắt	polarity=NEGATIVE
hồ hởi	polarity=POSITIVE
hổ thẹn	polarity=NEGATIVE
hóa điên	polarity=NEGATIVE
hóa điên hóa rồ	polarity=NEGATIVE
hoa hòe hoa sói	polarity=NEGATIVE
hoại thư	polarity=NEGATIVE
hoàn chỉnh	polarity=POSITIVE
hoàn hảo	polarity=POSITIVE
hoan hỉ	polarity=POSITIVE
hoàn mỹ	polarity=POSITIVE
hoàn thiện	polarity=POSITIVE
hoang	polarity=NEGATIVE
hoang mang	polarity=NEGATIVE
hoành tráng	polarity=POSITIVE
hoạt bát	polarity=POSITIVE
hoạt kê	polarity=POSITIVE
hôi hám	polarity=NEGATIVE
hời hợt	polarity=NEGATIVE
hối lộ	polarity=NEGATIVE
hôi miệng	polarity=NEGATIVE
hôi nách	polarity=NEGATIVE
hôi rình	polarity=NEGATIVE
hôi tanh	polarity=NEGATIVE
hôi thối	polarity=NEGATIVE
hom hem	polarity=NEGATIVE
hơn hẳn	polarity=POSITIVE
hỗn loạn	polarity=NEGATIVE
hơn trước	polarity=POSITIVE
hỏng	polarity=NEGATIVE
hợp lý	polarity=POSITIVE
hợp pháp	polarity=POSITIVE
hợp thời	polarity=POSITIVE
hợp vệ sinh	polarity=POSITIVE
hư	polarity=NEGATIVE
hủ bại	polarity=NEGATIVE
hư hại	polarity=NEGATIVE
hư hỏng	polarity=NEGATIVE
hung ác	polarity=NEGATIVE
hung bạo	polarity=NEGATIVE
hùng hậu	polarity=POSITIVE
hừng hực	polarity=POSITIVE
hứng khởi	polarity=POSITIVE
hùng mạnh	polarity=POSITIVE
hưng phấn	polarity=POSITIVE
hữu dụng	polarity=POSITIVE
hữu hiệu	polarity=POSITIVE
hữu ích	polarity=POSITIVE
hủy diệt	polarity=NEGATIVE
ít có	polarity=NEGATIVE
kém cỏi	polarity=NEGATIVE
khả quan	polarity=POSITIVE
khả thi	polarity=POSITIVE
khá tốt	polarity=POSITIVE
khác biệt	polarity=POSITIVE
khắc khổ	polarity=NEGATIVE
khắc nghiệt	polarity=NEGATIVE
khác thường	polarity=NEGATIVE
khám xét	polarity=NEGATIVE
khắt khe	polarity=NEGATIVE
khéo léo	polarity=POSITIVE
khiếm nhã	polarity=NEGATIVE
khiêm nhường	polarity=POSITIVE
khiêm tốn	polarity=POSITIVE
khiên cưỡng	polarity=NEGATIVE
khiêu dâm	polarity=NEGATIVE
khiếu nại	polarity=NEGATIVE
khó chịu	polarity=NEGATIVE
khó hiểu	polarity=NEGATIVE
khó khăn	polarity=NEGATIVE
khó tiêu	polarity=NEGATIVE
khó tính	polarity=NEGATIVE
khó uống	polarity=NEGATIVE
khoái	polarity=POSITIVE
khốc liệt	polarity=NEGATIVE
khỏe khoắn	polarity=POSITIVE
khỏe mạnh	polarity=POSITIVE
khỏi bệnh	polarity=POSITIVE
khởi sắc	polarity=POSITIVE
khởi tố	polarity=NEGATIVE
khốn cùng	polarity=NEGATIVE
khốn đốn	polarity=NEGATIVE
khôn khéo	polarity=POSITIVE
khốn khổ	polarity=NEGATIVE
khôn ngoan	polarity=POSITIVE
không biết điều	polarity=NEGATIVE
khủng hoảng	polarity=NEGATIVE
khủng hoảng lòng tin	polarity=NEGATIVE
khủng khiếp	polarity=NEGATIVE
khuyến khích	polarity=POSITIVE
kích động	polarity=NEGATIVE
kiểm điểm	polarity=NEGATIVE
kiện	polarity=NEGATIVE
kiện cáo	polarity=NEGATIVE
kiên cường	polarity=POSITIVE
kiên trì	polarity=POSITIVE
kiệt sức	polarity=NEGATIVE
kim trong bọc lâu ngày cũng lòi ra	polarity=NEGATIVE
kinh khủng	polarity=NEGATIVE
kinh tế khủng hoảng	polarity=NEGATIVE
kỹ càng	polarity=POSITIVE
kỳ diệu	polarity=POSITIVE
kỹ lưỡng	polarity=POSITIVE
la hét	polarity=NEGATIVE
lạc hậu	polarity=NEGATIVE
lạc mất	polarity=NEGATIVE
lạc quan	polarity=POSITIVE
lai căng	polarity=NEGATIVE
làm bẩn	polarity=NEGATIVE
làm giả	polarity=NEGATIVE
làm giàu	polarity=POSITIVE
làm hỏng	polarity=NEGATIVE
lầm lỗi	polarity=NEGATIVE
làm mất	polarity=NEGATIVE
lâng láo	polarity=NEGATIVE
lặng lẽ	polarity=NEGATIVE
lãng mạn	polarity=POSITIVE
lạnh gáy	polarity=NEGATIVE
lạnh lùng	polarity=NEGATIVE
lành mạnh	polarity=POSITIVE
lão hóa	polarity=NEGATIVE
lập công	polarity=POSITIVE
lập dị	polarity=NEGATIVE
lấp lánh	polarity=POSITIVE
lây bệnh	polarity=NEGATIVE
lệch lạc	polarity=NEGATIVE
lén lút	polarity=NEGATIVE
lếu láo	polarity=NEGATIVE
lêu lổng	polarity=NEGATIVE
lịch lãm	polarity=POSITIVE
lịch sự	polarity=POSITIVE
liều lĩnh	polarity=NEGATIVE
linh hoạt	polarity=POSITIVE
lo lắng	polarity=NEGATIVE
lố lăng	polarity=NEGATIVE
lo ngại	polarity=NEGATIVE
lõa lồ	polarity=NEGATIVE
loạn óc	polarity=NEGATIVE
loạn sắc	polarity=NEGATIVE
loạn thị	polarity=NEGATIVE
loạn trí	polarity=NEGATIVE
lỗi	polarity=NEGATIVE
lợi bất cập hại	polarity=NEGATIVE
lỗi chính tả	polarity=NEGATIVE
lợi hại	polarity=POSITIVE
lỗi hành văn	polarity=NEGATIVE
lỗi kỹ thuật	polarity=NEGATIVE
lỗi lầm	polarity=NEGATIVE
lỗi lớn	polarity=NEGATIVE
lợi sữa	polarity=POSITIVE
lợi thế	polarity=POSITIVE
lỗi thời	polarity=NEGATIVE
lôi thôi lếch thếch	polarity=NEGATIVE
lớn lao	polarity=POSITIVE
lổn nhổn	polarity=NEGATIVE
lộn xộn	polarity=NEGATIVE
long lanh	polarity=POSITIVE
lộng lẫy	polarity=POSITIVE
lỏng lẻo	polarity=NEGATIVE
lừa đảo	polarity=NEGATIVE
lừa gạt	polarity=NEGATIVE
luật nào cũng có kẽ hở	polarity=NEGATIVE
lung linh	polarity=POSITIVE
lười	polarity=NEGATIVE
lười biếng	polarity=NEGATIVE
lươn lẹo	polarity=NEGATIVE
lương thiện	polarity=POSITIVE
lý thú	polarity=POSITIVE
lý tưởng	polarity=POSITIVE
mắc bệnh	polarity=NEGATIVE
mắc lỗi	polarity=NEGATIVE
mắc phải	polarity=NEGATIVE
mại dâm	polarity=NEGATIVE
mầm bệnh	polarity=NEGATIVE
mặn	polarity=NEGATIVE
mặn mà	polarity=POSITIVE
mặn nồng	polarity=POSITIVE
man rợ	polarity=NEGATIVE
mãnh liệt	polarity=POSITIVE
mạnh mẽ	polarity=POSITIVE
mạo hiểm	polarity=NEGATIVE
mất bò mới lo làm chuồng	polarity=NEGATIVE
mất cả chì lẫn chài	polarity=NEGATIVE
mất cắp	polarity=NEGATIVE
mất chức	polarity=NEGATIVE
mất công	polarity=NEGATIVE
mất cướp	polarity=NEGATIVE
mất lòng	polarity=NEGATIVE
mất mát	polarity=NEGATIVE
mất máu	polarity=NEGATIVE
mất màu	polarity=NEGATIVE
mất mùa	polarity=NEGATIVE
mất ngủ	polarity=NEGATIVE
mất sạch	polarity=NEGATIVE
mất sức	polarity=NEGATIVE
mất tác dụng	polarity=NEGATIVE
mất thì giờ	polarity=NEGATIVE
mất tích	polarity=NEGATIVE
mất tiền	polarity=NEGATIVE
mất trắng	polarity=NEGATIVE
máu lạnh	polarity=NEGATIVE
mẫu mực	polarity=POSITIVE
may mắn	polarity=POSITIVE
mê tín	polarity=NEGATIVE
mềm mại	polarity=POSITIVE
mệt	polarity=NEGATIVE
mệt mỏi	polarity=NEGATIVE
miễn dịch	polarity=POSITIVE
miễn phí	polarity=POSITIVE
miệng còn hơi sữa	polarity=NEGATIVE
mịn	polarity=POSITIVE
mịn màng	polarity=POSITIVE
minh bạch	polarity=POSITIVE
minh mẫn	polarity=POSITIVE
mờ	polarity=NEGATIVE
mồ hôi trộm	polarity=NEGATIVE
mới lạ	polarity=POSITIVE
mới mẻ	polarity=POSITIVE
mỏi mệt	polarity=NEGATIVE
mù mờ	polarity=NEGATIVE
mù quáng	polarity=NEGATIVE
mùi hôi	polarity=NEGATIVE
mượt mà	polarity=POSITIVE
mỹ mãn	polarity=POSITIVE
nâng cao	polarity=POSITIVE
năng động	polarity=POSITIVE
nặng mùi	polarity=NEGATIVE
nặng nề	polarity=NEGATIVE
nên tránh	polarity=NEGATIVE
nết na	polarity=POSITIVE
ngăn nắp	polarity=POSITIVE
ngang ngược	polarity=NEGATIVE
ngang nhiên	polarity=NEGATIVE
ngang trái	polarity=NEGATIVE
nghèo	polarity=NEGATIVE
nghèo nàn	polarity=NEGATIVE
nghi ngờ	polarity=NEGATIVE
nghi vấn	polarity=NEGATIVE
nghiêm khắc	polarity=NEGATIVE
nghiêm trọng	polarity=NEGATIVE
nghiêm túc	polarity=POSITIVE
nghiện hút	polarity=NEGATIVE
nghiện rượu	polarity=NEGATIVE
ngộ độc	polarity=NEGATIVE
ngớ ngẩn	polarity=NEGATIVE
ngỡ ngàng	polarity=POSITIVE
ngô nghê	polarity=NEGATIVE
ngoan	polarity=POSITIVE
ngoạn mục	polarity=POSITIVE
ngoan ngoãn	polarity=POSITIVE
ngon	polarity=POSITIVE
ngon lành	polarity=POSITIVE
ngọt	polarity=POSITIVE
ngọt ngào	polarity=POSITIVE
ngu ngốc	polarity=NEGATIVE
nguy hại	polarity=NEGATIVE
nguy hiểm	polarity=NEGATIVE
nguy kịch	polarity=NEGATIVE
nhàm chán	polarity=NEGATIVE
nham hiểm	polarity=NEGATIVE
nhân đạo	polarity=POSITIVE
nhẫn tâm	polarity=NEGATIVE
nhanh chóng	polarity=POSITIVE
nhanh nhẹn	polarity=POSITIVE
nhanh trí	polarity=POSITIVE
nhạy bén	polarity=POSITIVE
nhầy nhụa	polarity=NEGATIVE
nhếch nhác	polarity=NEGATIVE
nhiễm	polarity=NEGATIVE
nhiễm bẩn	polarity=NEGATIVE
nhiễm bệnh	polarity=NEGATIVE
nhiễm độc	polarity=NEGATIVE
nhiễm khuẩn	polarity=NEGATIVE
nhiễm trùng	polarity=NEGATIVE
nhiều lời	polarity=NEGATIVE
nhịp nhàng	polarity=POSITIVE
nhơ bẩn	polarity=NEGATIVE
nhỏ mọn	polarity=NEGATIVE
nhốt	polarity=NEGATIVE
nhuận tràng	polarity=POSITIVE
nhục nhã	polarity=NEGATIVE
nhuốm bệnh	polarity=NEGATIVE
nhuyễn	polarity=POSITIVE
nỗ lực	polarity=POSITIVE
nổi bật	polarity=POSITIVE
nổi điên	polarity=NEGATIVE
nói dối	polarity=NEGATIVE
nổi giận	polarity=NEGATIVE
nói xấu	polarity=NEGATIVE
non	polarity=NEGATIVE
non tay	polarity=NEGATIVE
nóng bỏng	polarity=POSITIVE
nòng cốt	polarity=POSITIVE
nồng nàn	polarity=POSITIVE
nồng nhiệt	polarity=POSITIVE
nực cười	polarity=NEGATIVE
nức danh	polarity=POSITIVE
nức tiếng	polarity=POSITIVE
ổ bệnh	polarity=NEGATIVE
ô nhiễm	polarity=NEGATIVE
ô nhục	polarity=NEGATIVE
ô uế	polarity=NEGATIVE
ốm	polarity=NEGATIVE
ổn	polarity=POSITIVE
ổn định	polarity=POSITIVE
ớn lạnh	polarity=NEGATIVE
phá hoại	polarity=NEGATIVE
phá sản	polarity=NEGATIVE
phải chăng	polarity=POSITIVE
phạm pháp	polarity=NEGATIVE
phạm tội	polarity=NEGATIVE
phản bội	polarity=NEGATIVE
phản cách mạng	polarity=NEGATIVE
phản đối	polarity=NEGATIVE
phản động	polarity=NEGATIVE
phận mỏng	polarity=NEGATIVE
phàn nàn	polarity=NEGATIVE
phản trắc	polarity=NEGATIVE
phạt	polarity=NEGATIVE
phát bệnh	polarity=NEGATIVE
phát điên	polarity=NEGATIVE
phát huy	polarity=POSITIVE
phê bình	polarity=NEGATIVE
phi lý	polarity=NEGATIVE
phi thường	polarity=POSITIVE
phiến diện	polarity=NEGATIVE
phiền hà	polarity=NEGATIVE
phiền muộn	polarity=NEGATIVE
phiền não	polarity=NEGATIVE
phiền phức	polarity=NEGATIVE
phiền toái	polarity=NEGATIVE
phổ biến rộng rãi	polarity=POSITIVE
phổ dụng	polarity=POSITIVE
phòng bệnh	polarity=POSITIVE
phóng khoáng	polarity=POSITIVE
phong phú	polarity=POSITIVE
phù nề	polarity=NEGATIVE
phù phiếm	polarity=NEGATIVE
phúc hậu	polarity=POSITIVE
phục hồi	polarity=POSITIVE
quá đà	polarity=NEGATIVE
quá hạn	polarity=NEGATIVE
quá khích	polarity=NEGATIVE
quá mức	polarity=NEGATIVE
quá quắt	polarity=NEGATIVE
quá sức	polarity=NEGATIVE
quá trớn	polarity=NEGATIVE
quái ác	polarity=NEGATIVE
quái dị	polarity=NEGATIVE
quan liêu	polarity=NEGATIVE
quan ngại	polarity=NEGATIVE
quan trọng	polarity=POSITIVE
quặt quẹo	polarity=NEGATIVE
quý báu	polarity=POSITIVE
quý giá	polarity=POSITIVE
quỷ quyệt	polarity=NEGATIVE
quyến rũ	polarity=POSITIVE
ra tòa	polarity=NEGATIVE
rắc rối	polarity=NEGATIVE
rách việc	polarity=NEGATIVE
rầm rộ	polarity=POSITIVE
rắn chắc	polarity=POSITIVE
rạng ngời	polarity=POSITIVE
rạng rỡ	polarity=POSITIVE
rẻ	polarity=POSITIVE
rét buốt	polarity=NEGATIVE
rét đậm	polarity=NEGATIVE
rét hại	polarity=NEGATIVE
rệu rã	polarity=NEGATIVE
rệu rạo	polarity=NEGATIVE
rối bời	polarity=NEGATIVE
rối loạn	polarity=NEGATIVE
rối rắm	polarity=NEGATIVE
rối ren	polarity=NEGATIVE
rối tung	polarity=NEGATIVE
rộng lượng	polarity=POSITIVE
rộng rãi	polarity=POSITIVE
rực rỡ	polarity=POSITIVE
rủi ro	polarity=NEGATIVE
rùng rợn	polarity=NEGATIVE
sa sút	polarity=NEGATIVE
sa thải	polarity=NEGATIVE
sắc sảo	polarity=POSITIVE
sạch sẽ	polarity=POSITIVE
sai lầm	polarity=NEGATIVE
sai lệch	polarity=NEGATIVE
sai trái	polarity=NEGATIVE
sảng khoái	polarity=POSITIVE
sáng sủa	polarity=POSITIVE
sáng suốt	polarity=POSITIVE
sang trọng	polarity=POSITIVE
sành ăn	polarity=POSITIVE
sáo mòn	polarity=NEGATIVE
sáo rỗng	polarity=NEGATIVE
sát hại	polarity=NEGATIVE
sâu bệnh	polarity=NEGATIVE
sâu lắng	polarity=POSITIVE
sâu sắc	polarity=POSITIVE
siêu	polarity=POSITIVE
siêu đẳng	polarity=POSITIVE
sinh động	polarity=POSITIVE
sợ hãi	polarity=NEGATIVE
sơ sài	polarity=NEGATIVE
sơ suất	polarity=NEGATIVE
sôi nổi	polarity=POSITIVE
son sắt	polarity=POSITIVE
son trẻ	polarity=POSITIVE
sống động	polarity=POSITIVE
sống sót	polarity=POSITIVE
sốt cao	polarity=NEGATIVE
sự cố	polarity=NEGATIVE
sung mãn	polarity=POSITIVE
sung sức	polarity=POSITIVE
sung sướng	polarity=POSITIVE
suôn sẻ	polarity=POSITIVE
suy đồi	polarity=NEGATIVE
suy đốn	polarity=NEGATIVE
suy giảm	polarity=NEGATIVE
suy giảm miễn dịch	polarity=NEGATIVE
suy sụp	polarity=NEGATIVE
suy thoái	polarity=NEGATIVE
suy yếu	polarity=NEGATIVE
gây hậu quả nghiêm trọng	polarity=NEGATIVE
khuyến mãi	polarity=POSITIVE
sexy	polarity=POSITIVE
hot	polarity=POSITIVE
stress	polarity=NEGATIVE
giảm béo	polarity=POSITIVE
lành tính	polarity=POSITIVE
giảm trí nhớ	polarity=NEGATIVE
đột quỵ	polarity=NEGATIVE
vi phạm bản quyền	polarity=NEGATIVE
cai nghiện	polarity=POSITIVE
ô nhiễm không khí	polarity=NEGATIVE
ô nhiễm môi trường	polarity=NEGATIVE
miễn giảm học phí	polarity=POSITIVE
thiếu vốn	polarity=NEGATIVE
tái nghiện	polarity=NEGATIVE
viêm loét	polarity=NEGATIVE
đánh bom	polarity=NEGATIVE
lợi dụng chức vụ	polarity=NEGATIVE
vượt trội	polarity=POSITIVE
tiện dụng	polarity=POSITIVE
chiếm đoạt tài sản	polarity=NEGATIVE
có ý nghĩa	polarity=POSITIVE
gây tai nạn	polarity=NEGATIVE
xử phạt	polarity=NEGATIVE
bệnh thành tích	polarity=NEGATIVE
sụt giảm	polarity=NEGATIVE
quá đát	polarity=NEGATIVE
háo danh	polarity=NEGATIVE
vượt xa	polarity=POSITIVE
chạy án	polarity=NEGATIVE
mờ nhạt	polarity=NEGATIVE
quý hiếm	polarity=POSITIVE
đua xe	polarity=NEGATIVE
scandal	polarity=NEGATIVE
chết người	polarity=NEGATIVE
sạt lở	polarity=NEGATIVE
cháy nổ	polarity=NEGATIVE
vi phạm hành chính	polarity=NEGATIVE
nhiễm hiv	polarity=NEGATIVE
bắt mắt	polarity=POSITIVE
Hài Hòa	polarity=POSITIVE
Thanh Bình	polarity=POSITIVE
Yên Bình	polarity=POSITIVE
lây nhiễm	polarity=NEGATIVE
thể dục chữa bệnh	polarity=POSITIVE
độc hại nghề nghiệp	polarity=NEGATIVE
khủng hoảng chính trị	polarity=NEGATIVE
ăn nên làm ra	polarity=POSITIVE
khóc đứng khóc ngồi	polarity=NEGATIVE
đái dắt	polarity=NEGATIVE
phạm luật	polarity=NEGATIVE
thì thụt	polarity=NEGATIVE
tôn thờ	polarity=POSITIVE
tự tư tự lợi	polarity=NEGATIVE
sửa sai	polarity=POSITIVE
bán trời không văn tự	polarity=NEGATIVE
đi cổng sau	polarity=NEGATIVE
ngoắc ngoải	polarity=NEGATIVE
chung sống hòa bình	polarity=POSITIVE
bôi tro trét trấu	polarity=NEGATIVE
lẻn lút	polarity=NEGATIVE
thiếu đói	polarity=NEGATIVE
kề vai sát cánh	polarity=POSITIVE
bán trôn nuôi miệng	polarity=NEGATIVE
nói nhăng nói cuội	polarity=NEGATIVE
mê tít	polarity=POSITIVE
nói cạnh nói khóe	polarity=NEGATIVE
bôi tro trát trấu	polarity=NEGATIVE
nở hậu	polarity=POSITIVE
mãn nguyệt khai hoa	polarity=POSITIVE
trợ tim	polarity=POSITIVE
tự kỷ ám thị	polarity=NEGATIVE
khóc dở mếu dở	polarity=NEGATIVE
buôn dân bán nước	polarity=NEGATIVE
chụp giựt	polarity=NEGATIVE
trụy tim mạch	polarity=NEGATIVE
húy kị	polarity=NEGATIVE
làm mình làm mẩy	polarity=NEGATIVE
chí công vô tư	polarity=POSITIVE
láo lếu	polarity=NEGATIVE
lôm nhôm	polarity=NEGATIVE
thơm phưng phức	polarity=POSITIVE
xộc xà xộc xệch	polarity=NEGATIVE
thoáng đãng	polarity=POSITIVE
ẩm xìu	polarity=NEGATIVE
vô phước	polarity=NEGATIVE
dặt dẹo	polarity=NEGATIVE
vô kỉ luật	polarity=NEGATIVE
xinh xẻo	polarity=POSITIVE
thô thiển	polarity=NEGATIVE
nuột nà	polarity=POSITIVE
nhạt hoét	polarity=NEGATIVE
thõng thượt	polarity=NEGATIVE
ích kỉ	polarity=NEGATIVE
trống huếch trống hoác	polarity=NEGATIVE
mát rười rượi	polarity=POSITIVE
toàn mĩ	polarity=POSITIVE
vô lí	polarity=NEGATIVE
mát rượi	polarity=POSITIVE
tươi roi rói	polarity=POSITIVE
vạ vật	polarity=NEGATIVE
thương đau	polarity=NEGATIVE
khoai khoái	polarity=POSITIVE
ba hoa thiên địa	polarity=NEGATIVE
dị hờm	polarity=NEGATIVE
dị hợm	polarity=NEGATIVE
mù màu	polarity=NEGATIVE
chua lét	polarity=NEGATIVE
xấc lấc	polarity=NEGATIVE
vắng tanh vắng ngắt	polarity=NEGATIVE
sưng vều	polarity=NEGATIVE
sưng vếu	polarity=NEGATIVE
sứt sẹo	polarity=NEGATIVE
nghèo rớt	polarity=NEGATIVE
lèo khoèo	polarity=NEGATIVE
lẻo khoẻo	polarity=NEGATIVE
nhầu nát	polarity=NEGATIVE
chướng tai gai mắt	polarity=NEGATIVE
nguội tanh nguội ngắt	polarity=NEGATIVE
dai sức	polarity=POSITIVE
ngỗ nghịch	polarity=NEGATIVE
lạnh ngắt ngơ	polarity=NEGATIVE
bợt bạt	polarity=NEGATIVE
hiền thảo	polarity=POSITIVE
phi lí	polarity=NEGATIVE
chín ép	polarity=NEGATIVE
tậm tịt	polarity=NEGATIVE
thôi thối	polarity=NEGATIVE
hữu lí	polarity=POSITIVE
toàn tâm toàn ý	polarity=POSITIVE
lí thú	polarity=POSITIVE
dát gái	polarity=NEGATIVE
ba hoa chích chòe	polarity=NEGATIVE
văng mạng	polarity=NEGATIVE
vô nhân đạo	polarity=NEGATIVE
mệt lử cò bợ	polarity=NEGATIVE
mệt nhọc	polarity=NEGATIVE
ky bo	polarity=NEGATIVE
ý hợp tâm đầu	polarity=POSITIVE
rối tinh rối mù	polarity=NEGATIVE
mát dạ	polarity=POSITIVE
vêu vao	polarity=NEGATIVE
kì diệu	polarity=POSITIVE
bách chiến bách thắng	polarity=POSITIVE
ốm nhách	polarity=NEGATIVE
cao quí	polarity=POSITIVE
tươi thắm	polarity=POSITIVE
an lành	polarity=POSITIVE
mắt la mày lét	polarity=NEGATIVE
tươi sống	polarity=POSITIVE
ba trợn ba trạo	polarity=NEGATIVE
mát da mát thịt	polarity=POSITIVE
thượng phong	polarity=POSITIVE
kiên dũng	polarity=POSITIVE
xum xuê	polarity=POSITIVE
bố láo bố lếu	polarity=NEGATIVE
có da có thịt	polarity=POSITIVE
khoái khẩu	polarity=POSITIVE
chính đại quang minh	polarity=POSITIVE
hoen rỉ	polarity=NEGATIVE
bố lếu bố láo	polarity=NEGATIVE
tà gian	polarity=NEGATIVE
lộn bậy lộn bạ	polarity=NEGATIVE
rối bòng bong	polarity=NEGATIVE
chua loen loét	polarity=NEGATIVE
lử đử lừ đừ	polarity=NEGATIVE
tinh gọn	polarity=POSITIVE
chịu thương chịu khó	polarity=POSITIVE
thanh sạch	polarity=POSITIVE
rỗng tuếch rỗng toác	polarity=NEGATIVE
trái tính trái nết	polarity=NEGATIVE
mau mồm mau miệng	polarity=POSITIVE
mọt ruỗng	polarity=NEGATIVE
thưỡn thà thưỡn thẹo	polarity=NEGATIVE
dở khôn dở dại	polarity=NEGATIVE
phập phù	polarity=NEGATIVE
tuyệt mỹ	polarity=POSITIVE
mê li	polarity=POSITIVE
toàn thiện toàn mĩ	polarity=POSITIVE
hữu dũng vô mưu	polarity=NEGATIVE
trái nết	polarity=NEGATIVE
điệu nghệ	polarity=POSITIVE
hữu danh vô thực	polarity=NEGATIVE
mất nết	polarity=NEGATIVE
đường đường chính chính	polarity=POSITIVE
lầy lụa	polarity=NEGATIVE
cũ mèm	polarity=NEGATIVE
trống tuếch	polarity=NEGATIVE
tối tăm mày mặt	polarity=NEGATIVE
hoàn mĩ	polarity=POSITIVE
dở ông dở thằng	polarity=NEGATIVE
tanh banh	polarity=NEGATIVE
lằng nhà lằng nhằng	polarity=NEGATIVE
dở ẹt	polarity=NEGATIVE
tươi rói	polarity=POSITIVE
lười nhác	polarity=NEGATIVE
cỗi cằn	polarity=NEGATIVE
khô không khốc	polarity=NEGATIVE
tươi trẻ	polarity=POSITIVE
xuệch xoạc	polarity=NEGATIVE
hiền dịu	polarity=POSITIVE
đa dụng	polarity=POSITIVE
viêm nhiệt	polarity=NEGATIVE
trống huếch	polarity=NEGATIVE
trống tuếch trống toác	polarity=NEGATIVE
không đầu không đũa	polarity=NEGATIVE
mầu mỡ	polarity=POSITIVE
gầy nhỏng	polarity=NEGATIVE
hèn đớn	polarity=POSITIVE
vô tri	polarity=NEGATIVE
tươi hơn hớn	polarity=POSITIVE
diệu kì	polarity=POSITIVE
ma giáo	polarity=NEGATIVE
thơm lựng	polarity=POSITIVE
sáng giá	polarity=POSITIVE
chậm rì rì	polarity=NEGATIVE
hăng máu vịt	polarity=NEGATIVE
nguy ngập	polarity=NEGATIVE
xấu chơi	polarity=NEGATIVE
tuyệt mĩ	polarity=POSITIVE
vô hồn	polarity=NEGATIVE
đầu bảng	polarity=POSITIVE
phản cảm	polarity=NEGATIVE
nổi trội	polarity=POSITIVE
bấn loạn	polarity=NEGATIVE
có hại	polarity=NEGATIVE
có lợi	polarity=POSITIVE
lộ hàng	polarity=NEGATIVE
đáng nể	polarity=POSITIVE
vô nhân tính	polarity=NEGATIVE
có giá trị	polarity=POSITIVE
khỏe đẹp	polarity=POSITIVE
nghiện ma túy	polarity=NEGATIVE
bất bại	polarity=POSITIVE
toát mồ hôi hột	polarity=NEGATIVE
bị hại	polarity=NEGATIVE
bất bình thường	polarity=NEGATIVE
Sự suy giảm ôzôn	polarity=NEGATIVE
Ngộ độc asen	polarity=NEGATIVE
yêu râu xanh	polarity=NEGATIVE
bắn chết	polarity=NEGATIVE
cực mạnh	polarity=POSITIVE
nghịch dại	polarity=NEGATIVE
phim sex	polarity=NEGATIVE
giở trò đồi bại	polarity=NEGATIVE
trẻ đẹp	polarity=POSITIVE
web sex	polarity=NEGATIVE
sập nhà	polarity=NEGATIVE
sập cầu	polarity=NEGATIVE
hóc xương	polarity=NEGATIVE
giết người hàng loạt	polarity=NEGATIVE
hiến máu	polarity=POSITIVE
chống ẩm	polarity=POSITIVE
chống cháy	polarity=POSITIVE
gây án mạng	polarity=NEGATIVE
tiết kiệm điện	polarity=POSITIVE
ùn tắc giao thông	polarity=NEGATIVE
lừa tình	polarity=NEGATIVE
lừa tiền	polarity=NEGATIVE
gây tai nạn giao thông	polarity=NEGATIVE
khổ đau	polarity=NEGATIVE
vòi tiền	polarity=NEGATIVE
không làm chủ được tốc độ	polarity=NEGATIVE
siêu bền	polarity=POSITIVE
chết tại chỗ	polarity=NEGATIVE
bắn trọng thương	polarity=NEGATIVE
đâm trọng thương	polarity=NEGATIVE
xuống hạng	polarity=NEGATIVE
bẫy tình	polarity=NEGATIVE
tàn độc	polarity=NEGATIVE
tai nạn xe máy	polarity=NEGATIVE
mãn nhãn	polarity=POSITIVE
khủng bố tinh thần	polarity=NEGATIVE
bị thương nặng	polarity=NEGATIVE
đứt phanh	polarity=NEGATIVE
bán trinh	polarity=NEGATIVE
mua trinh	polarity=NEGATIVE
vi khuẩn gây bệnh	polarity=NEGATIVE
trái pháp luật	polarity=NEGATIVE
tốc độ cao	polarity=POSITIVE
bị bắt cóc	polarity=NEGATIVE
tươi đẹp	polarity=POSITIVE
đẹp da	polarity=POSITIVE
đánh giá cao	polarity=POSITIVE
mã độc	polarity=NEGATIVE
dưỡng da	polarity=POSITIVE
trị mụn	polarity=POSITIVE
khí độc	polarity=NEGATIVE
chất lượng cao	polarity=POSITIVE
vô văn hóa	polarity=NEGATIVE
tràn dầu	polarity=NEGATIVE
lội ngược dòng	polarity=POSITIVE
rất mạnh	polarity=POSITIVE
xả stress	polarity=POSITIVE
mất vệ sinh	polarity=NEGATIVE
hiệu quả cao	polarity=POSITIVE
săn chắc	polarity=POSITIVE
nhập lậu	polarity=NEGATIVE
nguồn bệnh	polarity=NEGATIVE
tuyệt đẹp	polarity=POSITIVE
bịa đặt trắng trợn	polarity=NEGATIVE
thơm ngon	polarity=POSITIVE
làm việc thiện	polarity=POSITIVE
lười học	polarity=NEGATIVE
tạt axit	polarity=NEGATIVE
bị loại	polarity=NEGATIVE
ảnh sex	polarity=NEGATIVE
viếng Bác	polarity=POSITIVE
bắt cóc con tin	polarity=NEGATIVE
hợp mốt	polarity=POSITIVE
hợp thời trang	polarity=POSITIVE
có giá	polarity=POSITIVE
ăn cắp bản quyền	polarity=NEGATIVE
bị rắn cắn	polarity=NEGATIVE
trái đạo lý	polarity=NEGATIVE
thiếu nước	polarity=NEGATIVE
thắng thầu	polarity=POSITIVE
sex game	polarity=NEGATIVE
chậm nói	polarity=NEGATIVE
cảnh sex	polarity=NEGATIVE
sa mạc hóa	polarity=NEGATIVE
bị bắt	polarity=NEGATIVE
không có lợi	polarity=NEGATIVE
rò điện	polarity=NEGATIVE
vực dậy	polarity=POSITIVE
lạm phát phi mã	polarity=NEGATIVE
siêu lạm phát	polarity=NEGATIVE
ngủ ngon	polarity=POSITIVE
lạnh thấu xương	polarity=NEGATIVE
mất điểm	polarity=NEGATIVE
mất sóng	polarity=NEGATIVE
gây hại	polarity=NEGATIVE
xấu trai	polarity=NEGATIVE
vượt khó	polarity=POSITIVE
chơi xấu	polarity=NEGATIVE
tăng sản lượng	polarity=POSITIVE
chơi bẩn	polarity=NEGATIVE
tuột dốc	polarity=NEGATIVE
sắc nét	polarity=POSITIVE
không thể thiếu	polarity=POSITIVE
chat sex	polarity=NEGATIVE
làm từ thiện	polarity=POSITIVE
phạm lỗi	polarity=NEGATIVE
xuống sắc	polarity=NEGATIVE
mất hết nhân tính	polarity=POSITIVE
thanh nhiệt	polarity=POSITIVE
giành chiến thắng	polarity=POSITIVE
đáp ứng nhu cầu	polarity=POSITIVE
vi phạm pháp luật	polarity=NEGATIVE
cố ý gây thương tích	polarity=NEGATIVE
bỏ lỡ cơ hội	polarity=NEGATIVE
nhiễm virus	polarity=NEGATIVE
bị lừa bán	polarity=NEGATIVE
giảm stress	polarity=POSITIVE
có lỗi	polarity=NEGATIVE
chửi bậy	polarity=NEGATIVE
bị bắt quả tang	polarity=NEGATIVE
sống trong sợ hãi	polarity=NEGATIVE
đốt xác	polarity=NEGATIVE
rút giấy phép	polarity=NEGATIVE
tốc váy	polarity=NEGATIVE
giảm trừ gia cảnh	polarity=POSITIVE
cạnh tranh không lành mạnh	polarity=NEGATIVE
thiếu cân	polarity=NEGATIVE
thiếu tháng	polarity=NEGATIVE
bỏ cơm	polarity=NEGATIVE
giảm mạnh	polarity=NEGATIVE
nghiện game	polarity=NEGATIVE
vi phạm giao thông	polarity=NEGATIVE
vi phạm nghiêm trọng	polarity=NEGATIVE
quầng thâm	polarity=NEGATIVE
bồi thường thiệt hại	polarity=NEGATIVE
dễ mến	polarity=POSITIVE
vượt ẩu	polarity=NEGATIVE
bị say	polarity=NEGATIVE
mát lạnh	polarity=POSITIVE
chống phá nhà nước	polarity=NEGATIVE
chọn sai vị trí	polarity=NEGATIVE
thu hồi sản phẩm	polarity=NEGATIVE
bị điểm thấp	polarity=NEGATIVE
mua bán trinh	polarity=NEGATIVE
đánh vợ	polarity=NEGATIVE
đánh chồng	polarity=NEGATIVE
vón cục	polarity=NEGATIVE
khó quên	polarity=POSITIVE
đáng quý	polarity=POSITIVE
trúng thưởng	polarity=POSITIVE
sưng tấy	polarity=NEGATIVE
chất gây ung thư	polarity=NEGATIVE
thượng thừa	polarity=POSITIVE
hút khách	polarity=POSITIVE
siêu chậm	polarity=NEGATIVE
bệnh hiểm nghèo	polarity=NEGATIVE
3-MCPD	polarity=NEGATIVE
mất an toàn	polarity=NEGATIVE
thiếu nghiêm túc	polarity=NEGATIVE
kiện ra tòa	polarity=NEGATIVE
mất bình tĩnh	polarity=NEGATIVE
thiếu lửa	polarity=NEGATIVE
thiếu sinh khí	polarity=NEGATIVE
chống viêm loét	polarity=POSITIVE
gây thiệt hại	polarity=NEGATIVE
bụi bẩn	polarity=NEGATIVE
không lành mạnh	polarity=NEGATIVE
DEHP	polarity=NEGATIVE
rất tốt	polarity=POSITIVE
tốt hơn	polarity=POSITIVE
không tốt	polarity=NEGATIVE
lag	polarity=NEGATIVE
cùi bắp	polarity=NEGATIVE
như khẹc	polarity=NEGATIVE
E102	polarity=NEGATIVE
gạ tình	polarity=NEGATIVE
phi thực tế	polarity=NEGATIVE
kém chất lượng	polarity=NEGATIVE
parabens	polarity=NEGATIVE
chưa đạt chuẩn	polarity=NEGATIVE
vượt quy chuẩn	polarity=NEGATIVE
thu giấy phép	polarity=NEGATIVE
tước giấy phép	polarity=NEGATIVE
tước quân tịch	polarity=NEGATIVE
buông lỏng quản lý	polarity=NEGATIVE
không có bằng cấp	polarity=NEGATIVE
không có giấy phép	polarity=NEGATIVE